strings
SYS_DIALOG_GENERIC_BUTTON1	
SYS_DIALOG_GENERIC_BUTTON2	
SYS_DIALOG_GENERIC_BUTTON3	
SYS_DIALOG_GENERIC_ITEM_OK	OK
SYS_DIALOG_GENERIC_ITEM_YES	是
SYS_DIALOG_GENERIC_ITEM_NO	否
SYS_DIALOG_GENERIC_ITEM_CANCEL	取消
SYS_DIALOG_GENERIC_ITEM_INVITE	邀请好友
SYS_DIALOG_GENERIC_ITEM_LATER	稍后
SYS_DIALOG_SAVE_CONFIRMATION_TEXT	要覆盖此数据吗？
SYS_DIALOG_SAVE_PROCESSING_TEXT	正在保存
SYS_DIALOG_SAVE_COMPLETED_TEXT	保存完毕。
SYS_DIALOG_SAVE_FAILED_TEXT	保存失败。
SYS_DIALOG_EXCHANGE_PLAYER_1P_TEXT	已更换1P和2P。\n您现在是1P。\n将继续进行菜单的操作。
SYS_DIALOG_EXCHANGE_PLAYER_2P_TEXT	已更换1P和2P。\n您现在是2P。\n将继续进行菜单的操作。
SYS_DIALOG_NETPLAY_TO_SWAP_TEXT	请选择要设置为1P的人。
SYS_DIALOG_SWAP_PLAYER_TEXT	成为了1P。\n菜单将由继续操作。
SYS_DIALOG_SWAP_PLAYER_TEXT_LONG	成为了1P。\n你现在是P。\n菜单将由继续操作。
SYS_DIALOG_ONLINE_CONTROLLER_TEXT	在线时只能使用1个手柄。\n要继续吗？
SYS_DIALOG_ONLINE_CONNECTING_TEXT	正在连接互联网⋯⋯
SYS_DIALOG_ONLINE_SEARCHING_TEXT	正在寻找等待中的好友。
SYS_DIALOG_ONLINE_CREATE_SESSION_TEXT	要设置密码吗？\n将密码告诉好友后，\n就可以只和该好友一起游玩。
SYS_DIALOG_ONLINE_CREATE_SESSION_WITHOUT_PASSWORD	没有密码
SYS_DIALOG_ONLINE_CREATE_SESSION_WITH_PASSWORD	有密码
SYS_DIALOG_ONLINE_CREATING_SESSION_TEXT	正在进行线上游戏的准备⋯⋯
SYS_DIALOG_ONLINE_CREATED_SESSION_TEXT	好友与您汇合后，您将收到通知。\n可以一边等待好友一边游玩。
SYS_DIALOG_ONLINE_CREATED_SESSION_TEXT_INVITE	要立刻邀请好友吗？\n选择“稍后”的话，可以从左侧的菜单中邀请好友。
SYS_DIALOG_ONLINE_CREATED_SESSION_SORT_TEXT	好友与您汇合后，您将收到通知。\n可以一边等待好友一边游玩。\n作品名的排列顺序将暂时更改为“按自己喜爱的顺序排序”。
SYS_DIALOG_ONLINE_CREATED_SESSION_SORT_TEXT_INVITE	游戏名称的排列顺序将暂时变为“按自己喜爱的顺序”。\n\n要立刻邀请好友吗？\n选择“稍后”的话，可以从左侧的菜单中邀请好友。\n
SYS_DIALOG_ONLINE_PASSWORD_MISMATCH_TEXT	密码错误。
SYS_DIALOG_ONLINE_FAILED_TO_JOIN_TEXT	与好友汇合失败。
SYS_DIALOG_ONLINE_WAITING_FOR_GUEST_TEXT	正在与汇合⋯⋯
SYS_DIALOG_ONLINE_WAITING_FOR_GUEST_4P_TEXT	正在与汇合⋯⋯
SYS_DIALOG_ONLINE_WAITING_FOR_HOST_TEXT	正在与汇合⋯⋯\n（您的保存数据不会更改）
SYS_DIALOG_ONLINE_ESTABLISHED_HOST_TEXT	加入了您的游戏。\n接下来将由进行菜单的操作。\n连接质量取决于您与对方之间的连接环境。
SYS_DIALOG_ONLINE_ESTABLISHED_HOST_4P_TEXT	加入了您的游戏。\n接下来将由进行菜单的操作。\n连接质量取决于您与对方之间的连接环境。
SYS_DIALOG_ONLINE_ESTABLISHED_GUEST_TEXT	您加入了的游戏。\n接下来将由进行菜单的操作。\n连接质量取决于您与对方之间的连接环境。
SYS_DIALOG_ONLINE_WAITING_ANOTHER_PLAYER_TEXT	其他玩家打开了HOME菜单\n或正在准备手柄等。
SYS_DIALOG_QUIT_ONLINE_PLAY_TEXT	将退出线上游戏。\n可以吗？
SYS_DIALOG_DURING_GUEST_OPERATION_TEXT	正在操作⋯⋯
SYS_DIALOG_DURING_GUEST_OPERATION_4P_TEXT	正在操作⋯⋯
SYS_DIALOG_DURING_HOST_OPERATION_TEXT	正在操作⋯⋯
SYS_DIALOG_LEAVING_ONLINE_PLAY_TEXT	正在结束线上游戏⋯⋯
SYS_DIALOG_NEW_ARRIVAL_INFORMATION_TEXT	已添加标题。
SYS_DIALOG_ERROR_EMULATOR_CRASHED_TEXT	游戏中发生错误。
SYS_DIALOG_ONLINE_PAUSE_ON_DISCONNECT_TEXT	与的连接已断开。\n接下来将无法继续游戏。\n只能使用随时保存功能。
SYS_DIALOG_ONLINE_PAUSE_ON_DISCONNECT_4P_TEXT	连接已断开。\n接下来将无法继续游戏。\n只能使用随时保存功能。
SYS_DIALOG_ONLINE_TITLE_PROHIBITED_TEXT	无法选择此游戏。
SYS_DIALOG_NETPLAY_TO_OPTIONAL_MODE_TEXT	已开启低延迟连接模式。\n进行线上游戏时，操作上的延迟会相应减少，\n但会对声音以及图像造成影响。\n（此设置不会被保存）
SYS_DIALOG_NETPLAY_TO_PRIMARY_MODE_TEXT	已关闭低延迟连接模式。\n（此设置不会被保存）
SYS_DIALOG_PROMOTION_03_MAIN_TITLE	超级马力欧兄弟 35周年特别发布
SYS_DIALOG_PROMOTION_03_MAIN_TEXT	1985年9月13日发售的《超级马力欧兄弟》，在2020年迎来了35周年。\n为配合这一重要时刻，将发布《超级马力欧收藏辑》。\n请乐享比Family Computer时代更高画质与音质的\n《超级马力欧兄弟》、《超级马力欧兄弟2》、\n《超级马力欧兄弟3》及《超级马力欧USA》。
SYS_DIALOG_PROMOTION_03_SUB_TEXT	在任天堂的主页上，正在介绍关于超级马力欧兄弟35周年的新作及活动信息。
SYS_HUD_GUIDE_PRO_CONFIRM	  确定
SYS_HUD_GUIDE_PRO_BACK	  返回
SYS_HUD_GUIDE_PRO_DETAILS	  详情
SYS_HUD_GUIDE_PRO_MOVE	  移动
SYS_HUD_GUIDE_PRO_MOVE2	  移动（长按排序）
SYS_HUD_GUIDE_PRO_SORT	  长按排序
SYS_HUD_GUIDE_PRO_PLAY	  开始
SYS_HUD_GUIDE_PRO_GUIDE	  操作指南
SYS_HUD_GUIDE_PRO_GUIDE_CHANGE	  更改操作方法
SYS_HUD_GUIDE_PRO_EXCHANGE	  更换1P/2P
SYS_HUD_GUIDE_PRO_SWAP	  更换1P
SYS_HUD_GUIDE_PRO_VOICE_CHAT	  如何进行语音聊天？
SYS_HUD_GUIDE_PRO_INGAME_PAUSE	 +   暂停菜单
SYS_HUD_GUIDE_PRO_INGAME_PAUSE2	  暂停菜单
SYS_HUD_GUIDE_PRO_INGAME_START	  START键
SYS_HUD_GUIDE_PRO_INGAME_SELECT	  SELECT键
SYS_HUD_GUIDE_PRO_INGAME_QUIT_ONLINE	 +   退出线上游戏
SYS_HUD_GUIDE_PRO_DETAILES_NEXT	  继续
SYS_HUD_GUIDE_PRO_DETAILES_NEXT2	  继续
SYS_HUD_GUIDE_PRO_COMMIT	  确定
SYS_HUD_GUIDE_PRO_CANCEL	  复原
SYS_HUD_GUIDE_PRO_NETPLAY_OPTIONAL_MODE	  开启低延迟连接模式
SYS_HUD_GUIDE_PRO_NETPLAY_PRIMARY_MODE	  关闭低延迟连接模式
SYS_HUD_GUIDE_JOY_L_CONFIRM	  确定
SYS_HUD_GUIDE_JOY_R_CONFIRM	  确定
SYS_HUD_GUIDE_JOY_L_BACK	  返回
SYS_HUD_GUIDE_JOY_R_BACK	  返回
SYS_HUD_GUIDE_JOY_L_DETAILS	  详情
SYS_HUD_GUIDE_JOY_R_DETAILS	  详情
SYS_HUD_GUIDE_JOY_L_MOVE	  移动
SYS_HUD_GUIDE_JOY_L_MOVE2	  移动（长按排序）
SYS_HUD_GUIDE_JOY_L_SORT	  长按排序
SYS_HUD_GUIDE_JOY_R_MOVE	  移动
SYS_HUD_GUIDE_JOY_R_MOVE2	  移动（长按排序）
SYS_HUD_GUIDE_JOY_R_SORT	  长按排序
SYS_HUD_GUIDE_JOY_L_PLAY	  开始
SYS_HUD_GUIDE_JOY_R_PLAY	  开始
SYS_HUD_GUIDE_JOY_L_GUIDE	  操作指南
SYS_HUD_GUIDE_JOY_L_GUIDE_CHANGE	  更改操作方法
SYS_HUD_GUIDE_JOY_R_GUIDE	  操作指南
SYS_HUD_GUIDE_JOY_R_GUIDE_CHANGE	  更改操作方法
SYS_HUD_GUIDE_JOY_L_EXCHANGE	  更换1P/2P
SYS_HUD_GUIDE_JOY_L_SWAP	  更换1P
SYS_HUD_GUIDE_JOY_R_EXCHANGE	  更换1P/2P
SYS_HUD_GUIDE_JOY_R_SWAP	  更换1P
SYS_HUD_GUIDE_JOY_L_VOICE_CHAT	  如何进行语音聊天？
SYS_HUD_GUIDE_JOY_R_VOICE_CHAT	  如何进行语音聊天？
SYS_HUD_GUIDE_JOY_L_INGAME_PAUSE	 +   暂停菜单
SYS_HUD_GUIDE_JOY_R_INGAME_PAUSE	 +   暂停菜单
SYS_HUD_GUIDE_JOY_L_INGAME_START	 +   START键
SYS_HUD_GUIDE_JOY_L_INGAME_START_01	 +   START键
SYS_HUD_GUIDE_JOY_R_INGAME_START	 +   START键
SYS_HUD_GUIDE_JOY_R_INGAME_START_01	 +   START键
SYS_HUD_GUIDE_JOY_L_INGAME_SELECT	 +   SELECT键
SYS_HUD_GUIDE_JOY_R_INGAME_SELECT	 +   SELECT键
SYS_HUD_GUIDE_JOY_L_INGAME_QUIT_ONLINE	 +   退出线上游戏
SYS_HUD_GUIDE_JOY_R_INGAME_QUIT_ONLINE	 +   退出线上游戏
SYS_HUD_GUIDE_JOY_L_DETAILS_NEXT	  继续
SYS_HUD_GUIDE_JOY_R_DETAILS_NEXT	  继续
SYS_HUD_GUIDE_JOY_L_COMMIT	  确定
SYS_HUD_GUIDE_JOY_R_COMMIT	  确定
SYS_HUD_GUIDE_JOY_L_CANCEL	  复原
SYS_HUD_GUIDE_JOY_R_CANCEL	  复原
SYS_HUD_GUIDE_JOY_L_NETPLAY_OPTIONAL_MODE	  开启低延迟连接模式
SYS_HUD_GUIDE_JOY_R_NETPLAY_OPTIONAL_MODE	  开启低延迟连接模式
SYS_HUD_GUIDE_JOY_L_NETPLAY_PRIMARY_MODE	  关闭低延迟连接模式
SYS_HUD_GUIDE_JOY_R_NETPLAY_PRIMARY_MODE	  关闭低延迟连接模式
SYS_HUD_GUIDE_LARK_HOME	  HOME菜单
SYS_HUD_GUIDE_LARK_HOME2	 : 
SYS_HUD_GUIDE_LARK_R_HOME	  HOME菜单
SYS_HUD_GUIDE_LARK_R_HOME2	 : 
SYS_HUD_GUIDE_LUCIA_HOME	  HOME菜单
SYS_HUD_GUIDE_LUCIA_HOME2	 : 
SYS_HUD_GUIDE_LARK_CAPTURE	  截图
SYS_HUD_GUIDE_LARK_CAPTURE2	 : 
SYS_HUD_GUIDE_LARK_L_CAPTURE	  截图
SYS_HUD_GUIDE_LARK_L_CAPTURE2	 : 
SYS_HUD_GUIDE_LUCIA_CAPTURE	  截图
SYS_HUD_GUIDE_LUCIA_CAPTURE2	 : 
SYS_HUD_GUIDE_LARK_CONFIRM	  确定
SYS_HUD_GUIDE_LARK_BACK	  返回
SYS_HUD_GUIDE_LARK_DETAILS	  详情
SYS_HUD_GUIDE_LARK_MOVE	  移动
SYS_HUD_GUIDE_LARK_MOVE2	  移动（长按排序）
SYS_HUD_GUIDE_LARK_SORT	  长按排序
SYS_HUD_GUIDE_LARK_PLAY	  开始
SYS_HUD_GUIDE_LARK_GUIDE	  操作指南
SYS_HUD_GUIDE_LARK_EXCHANGE	  更换1P/2P
SYS_HUD_GUIDE_LARK_VOICE_CHAT	  如何进行语音聊天？
SYS_HUD_GUIDE_LARK_INGAME_PAUSE	 +   暂停菜单
SYS_HUD_GUIDE_LARK_INGAME_QUIT_ONLINE	 +   退出线上游戏
SYS_HUD_GUIDE_LARK_DETAILES_NEXT	  继续
SYS_HUD_GUIDE_LARK_COMMIT	  确定
SYS_HUD_GUIDE_LARK_CANCEL	  复原
SYS_HUD_GUIDE_LARK_NETPLAY_OPTIONAL_MODE	  开启低延迟连接模式
SYS_HUD_GUIDE_LARK_NETPLAY_PRIMARY_MODE	  关闭低延迟连接模式
SYS_HUD_GUIDE_LARK_L_CONFIRM	  确定
SYS_HUD_GUIDE_LARK_L_BACK	  返回
SYS_HUD_GUIDE_LARK_L_DETAILS	  详情
SYS_HUD_GUIDE_LARK_L_MOVE	  移动
SYS_HUD_GUIDE_LARK_L_MOVE2	  移动（长按排序）
SYS_HUD_GUIDE_LARK_L_SORT	  长按排序
SYS_HUD_GUIDE_LARK_L_PLAY	  开始
SYS_HUD_GUIDE_LARK_L_GUIDE	  操作指南
SYS_HUD_GUIDE_LARK_L_EXCHANGE	  更换1P/2P
SYS_HUD_GUIDE_LARK_L_SWAP	  更换1P
SYS_HUD_GUIDE_LARK_L_VOICE_CHAT	  如何进行语音聊天？
SYS_HUD_GUIDE_LARK_L_INGAME_PAUSE	  暂停菜单
SYS_HUD_GUIDE_LARK_L_INGAME_START	  START键
SYS_HUD_GUIDE_LARK_L_INGAME_SELECT	  SELECT键
SYS_HUD_GUIDE_LARK_L_INGAME_QUIT_ONLINE	  退出线上游戏
SYS_HUD_GUIDE_LARK_L_DETAILES_NEXT	  继续
SYS_HUD_GUIDE_LARK_L_COMMIT	  确定
SYS_HUD_GUIDE_LARK_L_CANCEL	  复原
SYS_HUD_GUIDE_LARK_L_NETPLAY_OPTIONAL_MODE	  开启低延迟连接模式
SYS_HUD_GUIDE_LARK_L_NETPLAY_PRIMARY_MODE	  关闭低延迟连接模式
SYS_HUD_GUIDE_LARK_R_CONFIRM	  确定
SYS_HUD_GUIDE_LARK_R_BACK	  返回
SYS_HUD_GUIDE_LARK_R_DETAILS	  详情
SYS_HUD_GUIDE_LARK_R_MOVE	  移动
SYS_HUD_GUIDE_LARK_R_MOVE2	  移动（长按排序）
SYS_HUD_GUIDE_LARK_R_SORT	  长按排序
SYS_HUD_GUIDE_LARK_R_PLAY	  开始
SYS_HUD_GUIDE_LARK_R_GUIDE	  操作指南
SYS_HUD_GUIDE_LARK_R_EXCHANGE	  更换1P/2P
SYS_HUD_GUIDE_LARK_R_SWAP	  更换1P
SYS_HUD_GUIDE_LARK_R_VOICE_CHAT	  如何进行语音聊天？
SYS_HUD_GUIDE_LARK_R_INGAME_PAUSE	  暂停菜单
SYS_HUD_GUIDE_LARK_R_INGAME_START	  START键
SYS_HUD_GUIDE_LARK_R_INGAME_SELECT	  SELECT键
SYS_HUD_GUIDE_LARK_R_INGAME_QUIT_ONLINE	  退出线上游戏
SYS_HUD_GUIDE_LARK_R_DETAILES_NEXT	  继续
SYS_HUD_GUIDE_LARK_R_COMMIT	  确定
SYS_HUD_GUIDE_LARK_R_CANCEL	  复原
SYS_HUD_GUIDE_LARK_R_NETPLAY_OPTIONAL_MODE	  开启低延迟连接模式
SYS_HUD_GUIDE_LARK_R_NETPLAY_PRIMARY_MODE	  关闭低延迟连接模式
SYS_HUD_GUIDE_LARK_LR_CONFIRM	  确定
SYS_HUD_GUIDE_LARK_LR_BACK	  返回
SYS_HUD_GUIDE_LARK_LR_DETAILS	  详情
SYS_HUD_GUIDE_LARK_LR_MOVE	  移动
SYS_HUD_GUIDE_LARK_LR_MOVE2	  移动（长按排序）
SYS_HUD_GUIDE_LARK_LR_SORT	  长按排序
SYS_HUD_GUIDE_LARK_LR_PLAY	  开始
SYS_HUD_GUIDE_LARK_LR_GUIDE	  操作指南
SYS_HUD_GUIDE_LARK_LR_EXCHANGE	  更换1P/2P
SYS_HUD_GUIDE_LARK_LR_SWAP	  更换1P
SYS_HUD_GUIDE_LARK_LR_VOICE_CHAT	  如何进行语音聊天？
SYS_HUD_GUIDE_LARK_LR_INGAME_PAUSE	  暂停菜单
SYS_HUD_GUIDE_LARK_LR_INGAME_START	  START键
SYS_HUD_GUIDE_LARK_LR_INGAME_SELECT	  SELECT键
SYS_HUD_GUIDE_LARK_LR_INGAME_QUIT_ONLINE	  退出线上游戏
SYS_HUD_GUIDE_LARK_LR_DETAILES_NEXT	  继续
SYS_HUD_GUIDE_LARK_LR_COMMIT	  确定
SYS_HUD_GUIDE_LARK_LR_CANCEL	  复原
SYS_HUD_GUIDE_LARK_LR_NETPLAY_OPTIONAL_MODE	  开启低延迟连接模式
SYS_HUD_GUIDE_LARK_LR_NETPLAY_PRIMARY_MODE	  关闭低延迟连接模式
SYS_HUD_GUIDE_LUCIA_CONFIRM	  确定
SYS_HUD_GUIDE_LUCIA_BACK	  返回
SYS_HUD_GUIDE_LUCIA_DETAILS	  详情
SYS_HUD_GUIDE_LUCIA_MOVE	  移动
SYS_HUD_GUIDE_LUCIA_MOVE2	  移动（长按排序）
SYS_HUD_GUIDE_LUCIA_SORT	  长按排序
SYS_HUD_GUIDE_LUCIA_PLAY	  开始
SYS_HUD_GUIDE_LUCIA_GUIDE	  操作指南
SYS_HUD_GUIDE_LUCIA_EXCHANGE	  更换1P/2P
SYS_HUD_GUIDE_LUCIA_SWAP	  更换1P
SYS_HUD_GUIDE_LUCIA_VOICE_CHAT	  如何进行语音聊天？
SYS_HUD_GUIDE_LUCIA_INGAME_PAUSE	 +   暂停菜单
SYS_HUD_GUIDE_LUCIA_INGAME_QUIT_ONLINE	 +   退出线上游戏
SYS_HUD_GUIDE_LUCIA_DETAILES_NEXT	  继续
SYS_HUD_GUIDE_LUCIA_COMMIT	  确定
SYS_HUD_GUIDE_LUCIA_CANCEL	  复原
SYS_HUD_GUIDE_LUCIA_NETPLAY_OPTIONAL_MODE	  开启低延迟连接模式
SYS_HUD_GUIDE_LUCIA_NETPLAY_PRIMARY_MODE	  关闭低延迟连接模式
SYS_HUD_GUIDE_LARK3_CONFIRM	  确定
SYS_HUD_GUIDE_LARK3_BACK	  返回
SYS_HUD_GUIDE_LARK3_DETAILS	  详情
SYS_HUD_GUIDE_LARK3_MOVE	  移动
SYS_HUD_GUIDE_LARK3_MOVE2	  移动（长按排序）
SYS_HUD_GUIDE_LARK3_SORT	  长按排序
SYS_HUD_GUIDE_LARK3_PLAY	  开始
SYS_HUD_GUIDE_LARK3_GUIDE	  操作指南
SYS_HUD_GUIDE_LARK3_EXCHANGE	  更换1P/2P
SYS_HUD_GUIDE_LARK3_SWAP	  更换1P
SYS_HUD_GUIDE_LARK3_VOICE_CHAT	  如何进行语音聊天？
SYS_HUD_GUIDE_LARK3_INGAME_PAUSE	  暂停菜单
SYS_HUD_GUIDE_LARK3_INGAME_QUIT_ONLINE	  退出线上游戏
SYS_HUD_GUIDE_PRO_INGAME_QUIT_ONLINE2	  退出线上游戏
SYS_HUD_GUIDE_LARK3_DETAILES_NEXT	  继续
SYS_HUD_GUIDE_LARK3_COMMIT	  确定
SYS_HUD_GUIDE_LARK3_CANCEL	  复原
SYS_HUD_GUIDE_LARK3_NETPLAY_OPTIONAL_MODE	  开启低延迟连接模式
SYS_HUD_GUIDE_LARK3_NETPLAY_PRIMARY_MODE	  关闭低延迟连接模式
SYS_HUD_GUIDE_LARK3_INGAME_SELECT	  SELECT键
SYS_INFO_NICKNAME_OWN	
SYS_INFO_NICKNAME_HOST	
SYS_INFO_NICKNAME_GUEST	
SYS_INFO_NICKNAME_PLAYER2	
SYS_INFO_NICKNAME_PLAYER3	
SYS_INFO_NICKNAME_PLAYER4	
SYS_INFO_ROLE_PLAYER1	1P
SYS_INFO_ROLE_PLAYER2	2P
SYS_INFO_ROLE_PLAYER3	3P
SYS_INFO_ROLE_PLAYER4	4P
SYS_INFO_SESSION_PASSWORD	
SYS_INFO_NETWORK_UNSTABLE	可以在“ 设置”中更改连接模式
SYS_MENU_ROOT_ITEM_ONE_PLAYER	单人游戏
SYS_MENU_ROOT_ITEM_TWO_PLAYERS	双人游戏
SYS_MENU_ROOT_ITEM_THREE_PLAYERS	3人游戏
SYS_MENU_ROOT_ITEM_FOUR_PLAYERS	4人游戏
SYS_MENU_ROOT_ITEM_LOCAL_PLAY	多人游戏
SYS_MENU_LOCAL_PLAY_SUBJECT	多人游戏
SYS_MENU_ROOT_ITEM_ONLINE_PLAY	在线游戏
SYS_MENU_ROOT_ITEM_STOP_ONLINE_PLAY	退出在线游戏
SYS_MENU_ROOT_ITEM_SETTINGS	设置
SYS_MENU_ROOT_ITEM_INVITE	邀请好友
SYS_MENU_ROOT_SESSION_COUNTER	
SYS_MENU_ONLINE_GUIDE_SUBJECT	在线游戏
SYS_MENU_ONLINE_GUIDE_DESC1	· 可以在线上与好友两人一起玩游戏。\n\n· 可以一边独自玩游戏，一边等待好友的加入。\n\n· 可以通过智能手机软件\n　 《Nintendo Switch Online》进行语音聊天。
SYS_MENU_ONLINE_GUIDE_DESC1_4P	· 可以在线上与好友一起玩游戏。最多可供4人一起游玩。\n\n· 可以一边玩游戏，一边等待好友的加入。\n\n· 可以通过智能手机软件\n　 《Nintendo Switch Online》进行语音聊天。
SYS_MENU_ONLINE_ITEM_CREATE_SESSION	边玩边等待
SYS_MENU_ONLINE_ITEM_SESSION1	
SYS_MENU_ONLINE_ITEM_SESSION2	
SYS_MENU_ONLINE_ITEM_SESSION3	
SYS_MENU_ONLINE_ITEM_SESSION4	
SYS_MENU_ONLINE_ITEM_SESSION5	
SYS_MENU_ONLINE_ITEM_SESSION6	
SYS_MENU_ONLINE_ITEM_PLAYING	游戏中
SYS_MENU_ONLINE_DESC_CREATE_SESSION	一边独自玩游戏，一边等待好友的加入。
SYS_MENU_ONLINE_DESC_CREATE_SESSION_INVITE	一边玩游戏，一边等待好友的加入。\n还可以发送邀请给好友。
SYS_MENU_ONLINE_DESC_SESSION_LIST	选择一起玩游戏的好友  重新搜索
SYS_MENU_ONLINE_DESC_SESSION_LIST_JOY_L	选择一起玩游戏的好友  重新搜索
SYS_MENU_ONLINE_DESC_SESSION_LIST_JOY_R	选择一起玩游戏的好友  重新搜索
SYS_MENU_ONLINE_DESC_SESSION_LIST_LARK	选择一起玩游戏的好友  重新搜索
SYS_MENU_ONLINE_DESC_SESSION_LIST_LARK_L	选择一起玩游戏的好友  重新搜索
SYS_MENU_ONLINE_DESC_SESSION_LIST_LARK_R	选择一起玩游戏的好友  重新搜索
SYS_MENU_ONLINE_DESC_SESSION_LIST_LARK_LR	选择一起玩游戏的好友  重新搜索
SYS_MENU_ONLINE_DESC_SESSION_LIST_LUCIA	选择一起玩游戏的好友  重新搜索
SYS_MENU_ONLINE_DESC_SESSION_LIST_LARK3	选择一起玩游戏的好友  重新搜索
SYS_MENU_ONLINE_DESC_SESSION_LIST_INVITE	选择要汇合的好友  重新搜索
SYS_MENU_ONLINE_DESC_SESSION_LIST_JOY_L_INVITE	选择要汇合的好友  重新搜索
SYS_MENU_ONLINE_DESC_SESSION_LIST_JOY_R_INVITE	选择要汇合的好友  重新搜索
SYS_MENU_ONLINE_DESC_SESSION_LIST_LARK_INVITE	选择要汇合的好友  重新搜索
SYS_MENU_ONLINE_DESC_SESSION_LIST_LARK_L_INVITE	选择要汇合的好友  重新搜索
SYS_MENU_ONLINE_DESC_SESSION_LIST_LARK_R_INVITE	选择要汇合的好友  重新搜索
SYS_MENU_ONLINE_DESC_SESSION_LIST_LARK_LR_INVITE	选择要汇合的好友  重新搜索
SYS_MENU_ONLINE_DESC_SESSION_LIST_LUCIA_INVITE	选择要汇合的好友  重新搜索
SYS_MENU_ONLINE_DESC_SESSION_LIST_LARK3_INVITE	选择要汇合的好友  重新搜索
SYS_MENU_ONLINE_NOTICE_NOT_FOUND	无法找到能与之一起玩的好友
SYS_MENU_ONLINE_NOTICE_NOT_FOUND_INVITE	无法找到正在游玩的好友
SYS_MENU_ONLINE_KEYBOARD_HEADER	请输入密码（3位数字）
SYS_MENU_ONLINE_KEYBOARD_GUIDE	3位数字
SYS_MENU_SETTINGS_ITEM_4_3	4:3
SYS_MENU_SETTINGS_ITEM_PIXEL_PERFECT	原始比例
SYS_MENU_SETTINGS_ITEM_CRT	模拟电视
SYS_MENU_SETTINGS_DESC_GAME_SCREEN	游戏画面
SYS_MENU_SETTINGS_DESC_GUIDE_DISPLAY	游戏中显示按键分配
SYS_MENU_SETTINGS_ITEM_GUIDE_DISPLAY	显示
SYS_MENU_SETTINGS_DESC_VIBRATE	手柄振动
SYS_MENU_SETTINGS_ITEM_VIBRATE	振动
SYS_MENU_PAUSE_ITEM_CONTINUE	继续
SYS_MENU_PAUSE_ITEM_LOAD	读取
SYS_MENU_PAUSE_ITEM_SAVE	随时保存
SYS_MENU_PAUSE_ITEM_RESET	重置
SYS_MENU_PAUSE_ITEM_RETURN_TO_MENU	返回选择游戏画面
SYS_MENU_PAUSE_SWAPPLAYER_1	
SYS_MENU_PAUSE_SWAPPLAYER_2	
SYS_MENU_PAUSE_SWAPPLAYER_3	
SYS_MENU_DETAILS_DESC_RELEASE_INFO	　　年发售
SYS_MENU_DETAILS_DESC_PLAY_INFO_LONG_TIME	游戏人数：人　　游戏时间：小时分钟
SYS_MENU_DETAILS_DESC_PLAY_INFO_SHORT_TIME	游戏人数：人　　游戏时间：分钟
SYS_MENU_DETAILS_DESC_PLAY_INFO_NO_TIME	游戏人数：人
SYS_MENU_DETAILS_DESC_SAVE_DATA	セーブデータ
SYS_MENU_DETAILS_DESC_PLAY_COUNT	プレイ回数：回
SYS_MENU_DETAILS_DESC_PLAY_TIME_SHORT	プレイ時間：分
SYS_MENU_DETAILS_DESC_PLAY_TIME_LONG	プレイ時間：時間分
SYS_MENU_DETAIL_PAGE	 / 
SYS_MENU_SAVESLOT_NO_IMAGE	No Data
SYS_MENU_SAVESLOT_ITEM_EMPTY	保存数据
SYS_MENU_SAVESLOT_ITEM_VALID	保存数据\n// :
SYS_MENU_SORT_INDEX	●
SYS_MENU_SORT_INDEX_00	〇
SYS_MENU_SPECIAL_EMBLEM	SP
SYS_MENU_SPECIAL_TEXT	SPECIAL
SYS_MENU_SPECIAL2_TEXT	SPECIAL
SYS_MENU_NEW_GAME_TEXT	NEW
SYS_MENU_FRIENDPRESENCE	正在游玩：
SYS_NOTIFICATION_QUIT_ONLINE_PLAY_TEXT	已退出线上游戏。
SYS_NOTIFICATION_OTHER_PLAYER_MISSING_TEXT	与的连接已断开。\n将一边游玩一边等待好友的加入。
SYS_NOTIFICATION_OTHER_PLAYER_MISSING_4P_TEXT	与的连接已断开。\n将继续边游玩边等待好友的加入。
SYS_NOTIFICATION_OTHER_PLAYER_MISSING_4P_TEXT_GUEST	与的连接已断开。
SYS_NOTIFICATION_OTHER_PLAYER_MISSING2_TEXT	与的连接已断开。
SYS_NOTIFICATION_UNSTABLE_NETWORK_TEXT	由于您与对方的连接不稳定，可能无法流畅地进行游戏。\n可以在“ 设置”中更改连接模式。
SYS_NOTIFICATION_UNSTABLE_NETWORK2_TEXT	由于您与对方的连接不稳定，可能无法流畅地进行游戏。
SYS_NOTIFICATION_CONNECTED_CONTROLLER_NUM_1_TEXT	连接中的手柄数量已变为1个。
SYS_NOTIFICATION_CONNECTED_CONTROLLER_NUM_2_TEXT	连接中的手柄数量已变为2个。
SYS_NOTIFICATION_CONNECTED_CONTROLLER_NUM_3_TEXT	连接中的手柄数量已变为3个。
SYS_NOTIFICATION_CONNECTED_CONTROLLER_NUM_4_TEXT	连接中的手柄数量已变为4个。
SYS_NOTIFICATION_OPERATION_DENIED_TEXT	正在操作⋯⋯
SYS_NOTIFICATION_OPERATION_DENIED2_TEXT	正在操作⋯⋯
SYS_NOTIFICATION_DENIED_MOVE_OPERATION_TEXT	无法移动作品。\n需要在排序中更改为“按自己喜爱的顺序排序”。
SYS_NOTIFICATION_PLAYER_ORDER_TEXT	已更改手柄的分配。
SYS_NOTIFICATION_INGAME_CAUTION_STICK_TEXT	请勿用手掌等易受伤害的皮肤部位操作手柄的摇杆。
SYS_POPUP_GUIDE_PRO_CONTROLLER_SELECT	按键移动光标
SYS_POPUP_GUIDE_PRO_CONTROLLER_START	按键开始游戏
SYS_POPUP_GUIDE_JOY_L_CONTROLLER_SELECT	 + 移动光标
SYS_POPUP_GUIDE_JOY_L_CONTROLLER_START	 + 开始游戏
SYS_POPUP_GUIDE_JOY_L_CONTROLLER_START_01	 + 开始游戏
SYS_POPUP_GUIDE_JOY_R_CONTROLLER_SELECT	 + 移动光标
SYS_POPUP_GUIDE_JOY_R_CONTROLLER_START	 + 开始游戏
SYS_POPUP_GUIDE_JOY_R_CONTROLLER_START_01	 + 开始游戏
SYS_POPUP_GUIDE_LARK_L_CONTROLLER_SELECT	按键移动光标
SYS_POPUP_GUIDE_LARK_L_CONTROLLER_START	按键开始游戏
SYS_POPUP_GUIDE_LARK_R_CONTROLLER_SELECT	按键移动光标
SYS_POPUP_GUIDE_LARK_R_CONTROLLER_START	按键开始游戏
SYS_POPUP_GUIDE_PRO_PAUSE_MENU	 + 暂停游戏
SYS_POPUP_GUIDE_PRO_PAUSE_MENU_01	暂停游戏
SYS_POPUP_GUIDE_JOY_L_PAUSE_MENU	 + 暂停游戏
SYS_POPUP_GUIDE_JOY_R_PAUSE_MENU	 + 暂停游戏
SYS_POPUP_GUIDE_LARK_PAUSE_MENU	 + 暂停游戏
SYS_POPUP_GUIDE_LARK_L_PAUSE_MENU	按键暂停游戏
SYS_POPUP_GUIDE_LARK_R_PAUSE_MENU	按键暂停游戏
SYS_POPUP_GUIDE_LUCIA_PAUSE_MENU	 + 暂停游戏
SYS_POPUP_GUIDE_LARK3_PAUSE_MENU	按键暂停游戏
SYS_POPUP_GUIDE_PRO_SWAP_PLAYERS	在暂停菜单按键更换1P/2P
SYS_POPUP_GUIDE_JOY_L_SWAP_PLAYERS	在暂停菜单按键更换1P/2P
SYS_POPUP_GUIDE_JOY_R_SWAP_PLAYERS	在暂停菜单按键更换1P/2P
SYS_POPUP_GUIDE_LARK_SWAP_PLAYERS	在暂停菜单更换1P/2P。
SYS_POPUP_GUIDE_4P_SWAP_PLAYERS	请在暂停菜单中更换1P。
SYS_POPUP_GUIDE_FINGER_CURSOR	用移动手掌光标、用（按下）拍手
SYS_POPUP_GUIDE_FINGER_CURSOR_01	按住后再按为手掌光标，按下为拍手
SYS_POPUP_GUIDE_LARK_SYSTEM_BUTTON_HOME	按键前往HOME菜单
SYS_POPUP_GUIDE_LARK_SYSTEM_BUTTON_CAPTURE	按键截图
SYS_POPUP_GUIDE_LARK_R_SYSTEM_BUTTON_HOME	按键前往HOME菜单
SYS_POPUP_GUIDE_LARK_L_SYSTEM_BUTTON_CAPTURE	按键截图
SYS_POPUP_GUIDE_LUCIA_SYSTEM_BUTTON_HOME	按键前往HOME菜单
SYS_POPUP_GUIDE_LUCIA_SYSTEM_BUTTON_CAPTURE	按键截图
SYS_POPUP_GUIDE_PRO_CONTROLGUIDE	在暂停菜单中按键\n可以确认按键配置。
SYS_POPUP_GUIDE_JOY_L_CONTROLGUIDE	在暂停菜单中按键\n可以确认按键配置。
SYS_POPUP_GUIDE_JOY_R_CONTROLGUIDE	在暂停菜单中按键\n可以确认按键配置。
SYS_POPUP_GUIDE_LARK3_CONTROLGUIDE	在暂停菜单中按键\n可以确认按键配置。
SYS_NOTIFICATION_ONLINE_SOUND	由于连接不稳定，无法正常播放声音。
SYS_SORT_ORDER_CUSTOM	按自己喜爱的顺序
SYS_SORT_ORDER_RELEASE_DATE	按发售日顺序
SYS_SORT_ORDER_TITLE_NAME	按标题名称顺序
SYS_SORT_ORDER_PUBLISHER	按出版商顺序
SYS_SORT_ORDER_2PLAYER_GAMES	按2P同时游玩顺序
SYS_SORT_ORDER_DELIVERY_DATE	按发送顺序
SYS_SORT_ORDER_DESC_TEXT	更改作品的排序
SYS_SORT_ORDER_NAME_CUSTOM	按自己喜爱的顺序排序
SYS_SORT_ORDER_NAME_ALPHABETICAL	按日语排序
SYS_SORT_ORDER_NAME_RELEASE_DATE	按已发售排序
SYS_SORT_ORDER_NAME_RECENTLY_PLAYED	按最近游玩排序
SYS_SORT_ORDER_NAME_PLAY_TIME	按游玩时长排序
SYS_SORT_HEADING_PLAY_TIME	分钟
SYS_SORT_HEADING_PLAY_TIME_2	不到1分钟
SYS_SORT_HEADING_DATE_PLAYED_1	//
SYS_SORT_HEADING_DATE_PLAYED_2	/
SYS_USER_GUIDE_CONTROLLER_A	A
SYS_USER_GUIDE_CONTROLLER_B	B
SYS_USER_GUIDE_CONTROLLER_X	X
SYS_USER_GUIDE_CONTROLLER_Y	Y
SYS_USER_GUIDE_CONTROLLER_L	L
SYS_USER_GUIDE_CONTROLLER_R	R
SYS_USER_GUIDE_CONTROLLER_DPAD	十字键
SYS_USER_GUIDE_CONTROLLER_LARK3_DPAD	十字键
SYS_USER_GUIDE_CONTROLLER_SELECT	SELECT
SYS_USER_GUIDE_CONTROLLER__START	START
SYS_USER_GUIDE_PRO_POINTER	手掌光标\n（按下拍手）\n※仅限线上游戏时
SYS_USER_GUIDE_PRO_POINTER_NUS	：手掌光标（按下拍手）\n※仅限线上游戏时
SYS_USER_GUIDE_NUS_3DSTICK	3D摇杆
SYS_USER_GUIDE_NUS_Z	Z扳机
SYS_USER_GUIDE_NUS_L	L扳机
SYS_USER_GUIDE_NUS_R	R扳机
SYS_USER_GUIDE_NUS_C_UP	
SYS_USER_GUIDE_NUS_C_DOWN	
SYS_USER_GUIDE_NUS_C_RIGHT	
SYS_USER_GUIDE_NUS_C_LEFT	
SYS_USER_GUIDE_NUS_A	
SYS_USER_GUIDE_NUS_B	
SYS_USER_GUIDE_JOY_L_COMBINATION	 +  SELECT     +  START
SYS_USER_GUIDE_JOY_R_COMBINATION	 +  SELECT     +  START
SYS_USER_GUIDE_NUS_COMBINATION	 + ：
SYS_USER_GUIDE_NUS_COMBINATION_01	 + ：
SYS_USER_GUIDE_NUS_COMBINATION_02	 + ：START
SYS_USER_GUIDE_NUS_COMBINATION_03	 + ：START
SYS_USER_GUIDE_NUS_COMBINATION_04	 + 
SYS_USER_GUIDE_NUS_COMBINATION_05	 + ：
SYS_USER_GUIDE_NUS_COMBINATION_06	 + ：
SYS_USER_GUIDE_NUS_COMBINATION_07	 + ：
SYS_USER_GUIDE_NUS_COMBINATION_08	：Z扳机
SYS_USER_GUIDE_NUS_COMBINATION_09	：Z扳机
SYS_USER_GUIDE_LARK_COMBINATION	 +  暂停菜单
SYS_USER_GUIDE_LUCIA_COMBINATION	 +  暂停菜单
SYS_USER_GUIDE_PAUSE_MENU	暂停菜单
SYS_USER_GUIDE_LARK3_PAUSE_MENU	：暂停菜单
SYS_USER_GUIDE_SYSTEM_HOME	 HOME菜单
SYS_USER_GUIDE_LARK3_SYSTEM_HOME	：HOME菜单
SYS_USER_GUIDE_SYSTEM_CAPTURE	 截图
SYS_USER_GUIDE_SYSTEM_CAPTURE2	截图 
SYS_USER_GUIDE_LARK3_SYSTEM_CAPTURE	：截图
SYS_USER_GUIDE_MICROPHONE	麦克风
SYS_USER_GUIDE_MICROPHONE_VOLUME	麦克风音量
SYS_USER_GUIDE_MICROPHONE_NOT_SUPPORTED	此握法无法\n使用麦克风
SYS_USER_GUIDE_MICROPHONE_NOT_SUPPORTED_00	此握法无法\n使用麦克风
META_TITLE_COMMENT_N_3013_j	熟悉的角色急速飞驰！\n使用道具击飞劲敌！！\n\n本作品发售于1996年，是Nintendo 64上的动作竞速游戏。\n马力欧、酷霸王、桃花公主、耀西等《超级马力欧》中的角色\n将驾驶卡丁车进行竞赛。利用强化道具一口气超越对手，\n利用妨碍道具将对手击落，如何才能战胜对手将成为比赛的关键。\n在哪里使用哪种道具，选择哪条赛道，选择好战术战胜对方\n赢得比赛吧。游戏中共有20条赛道，在“马力欧大奖赛”、“VS”和\n“计时赛”里有16条共通赛道，在“对战”里有4条专用赛道。\n“马力欧赛道”和“酷霸王城堡”等赛道都有着各自的特色。\n另外，赛道中有着各种机关和近路，每次行驶在赛道上\n或许都会发现新的攻略方法。
META_TITLE_COMMENT_N_3017_j	轻松愉快的正式网球！不管是单人还是多人都可以乐在其中。\n\n本作品发售于2000年，是Nintendo 64上的运动游戏。\n马力欧、路易吉、耀西等马力欧系列中耳熟能详的角色将会登场，\n并用网球进行对决。和实际中的网球一样，可以打出各种击球，\n即使不去记住那些困难的操作，也可以轻松地享受网球的乐趣。\n玩家可以游玩多种游戏模式，例如自由选择角色与场地\n进行1场比赛的轻松对战“自由对战”、一边进行网球比赛，\n一边将球从球场上出现的圆圈中击穿过去积累“圆环分数”的\n“圆环击球”以及依靠道具左右比赛胜利的“酷霸王场地”等。
META_TITLE_COMMENT_N_3030_j	出击！星际火狐！\n以宇宙为舞台，充满爽快感的射击游戏。\n\n本作品发售于1997年，是Nintendo 64上的射击游戏。\n故事发生在因天才科学家安德罗斯博士而陷入毁灭危机的\n“莱拉特星系”。玩家需要扮演游击队星际火狐的队长\n火狐·麦克罗德操纵战斗机艾英粉碎安德罗斯军的野心。\n游戏的最终目标是打败维诺星上的安德罗斯。\n与火狐一起出击的是3名性格各异的伙伴。在他们的帮助下，\n可以获取各种有用的提示以及发现新的路线。当然，我们有时候\n也要去帮助对方。如何在冷酷无情的敌人的攻击下守护伙伴，\n就需要看身为队长的你的技术是否经得住考验了。\n利用后空翻、U型翻转等丰富的动作，逐个击败迫近的敌人吧。\n除了主线故事，在游戏中还能乐享可供4人对战的“VS.”模式。\n华丽地操纵艾英，第一个获得胜利的玩家究竟会是谁呢？
META_TITLE_COMMENT_N_3031_j	操作3D样貌的马力欧，\n夺回被酷霸王占领的蘑菇城堡！\n\n本作品发售于1996年，是Nintendo 64上的动作游戏。\n在本游戏《超级马力欧64》中，由横向滚动的二维场景\n制作的马力欧系列，首次进化成了三维世界。\n利用3D显示的马力欧丰富多彩的动作来收集“力量之星”，\n救出被酷霸王带入画中的桃花公主和奇诺比奥。\n跳跃时空翻、踢墙后高高跳起，一边享受轻快的动作，\n一边探索蘑菇城堡吧。
META_TITLE_COMMENT_N_3036_j	在绘本世界中展开的手工（手工制作）世界！\n\n本作品发售于1997年，是Nintendo 64上的动作游戏。\n耀西他们居住的世界突然被封入了绘本之中。\n在酷霸王宝宝夺走了“Super Happy Tree”后，\n大家都变成了柔弱无力的耀西……但是，留在岛上某个角落里的\n6个蛋却安然无事！从蛋中孵化出来的“小耀西”开始了冒险。\n因为他们相信只要自己吃下很多水果获得幸福，大家就都能获得幸福。\n在本作中，玩家不仅要“朝着终点前进”，还要从关卡内众多的\n水果中获得30个水果并以此过关。在游戏中可以体验到多种玩法，\n比如“不熟悉游戏之前，多多收集水果过关”，或“熟悉游戏之后，\n就争取获得高分并过关”等等。
META_TITLE_COMMENT_N_3038_j	为了从恶徒手中保护海拉鲁，林克开始了一场穿越时空的冒险。\n\n本作品发售于1998年，是Nintendo 64上的动作冒险游戏。\n居住在科奇里森林中的少年林克，从森林的守护神\n德库树长老那里收到了离开森林前往海拉鲁城堡的命令。\n玩家将操作林克，一边与海拉鲁各地的人们交流一边进行冒险。\n在迷宫中需要解开层层谜题，前往最深处，并打倒那里的头目。\n思考如何使用道具，开启房间内的机关后，前进的道路就会出现。\n听取帮助林克的妖精娜薇的建议，尝试进行各种各样的动作吧。
META_TITLE_COMMENT_N_3029_j	“这是对人类所犯之罪的惩罚吗？”\n以近未来的日本为舞台的动作射击游戏。\n\n本作品发售于2000年，是Nintendo 64上的动作射击游戏。\n在《罪と罰 地球の継承者》中除了有让人紧张的屏住呼吸的\n连续射击之外，剧情也是相当有深度。是以射击为中心进行游戏，\n还是以剧情为中心进行游戏，一切都由你来决定！在故事的结局，\nSaki发现了什么……人类是否还有希望？\n※以上内容改写自当时包装盒背面的介绍。
META_TITLE_COMMENT_N_3034_j	化身特殊部队“S.C.A.T.”的一员，夺回军事卫星GULF！\n\n本作品发售于1999年，是Nintendo 64上的3D射击动作游戏。\n地球轨道上的攻击卫星GULF受人操控，发射高能激光攻击宇宙开发中心。\n距离GULF充能结束，开始下次攻击只剩下几个小时。\n你将扮演特种部队“S.C.A.T.”（Strategic Covert Actions Team）的\n成员Jean-Luc，潜入GULF管控系统所在的Westham工厂聚集区里的\n秘密军事设施，并夺回GULF的控制权。在最多可供4人游玩的\nVERSUS模式中，可用角色的数量将随着STORY模式的进展而增加。
META_TITLE_COMMENT_N_2992_j	马力欧在绘本一样的世界中大展身手！\n出发去冒险，夺回Star Spirits吧。\n\n本作品发售于2000年，是Nintendo 64上的动作角色扮演游戏。\n在夜空遥远的彼方，有一个叫做Star Heaven的地方。\n在那里，由7个Star Spirits守护，拥有能实现愿望之力的\n“Star Rod”被大魔王酷霸王夺走了。对此事一无所知的\n马力欧收到了来自桃花公主，希望能邀请他去参加聚会的来信。\n随后，马力欧便与路易吉一起前往了桃花公主所在的蘑菇城堡。\n但他们并不知道这一切都是由已获得强大力量的酷霸王所设下的\n圈套……操作马力欧在场景中冒险，救出被酷霸王抓住的Star Spirits\n和桃花公主吧。游戏中有着很多马力欧系列中令人耳熟能详的机关。\n像是敲击后就会出现各种效果的“砖块”以及可以进入其中的\n“水管”等等。在与敌人的对战中，看准时机按下按键使用\n“动作指令”。只要能熟练使用各种强力攻击和防御的招式，\n在对战中就能轻松取胜。
META_TITLE_COMMENT_N_4868_j	Banjo和Kazooie那充满力量的动作大冒险即将开始！\n\n本作品发售于1998年，是Nintendo 64上的动作游戏。\n公熊（Banjo）和雌鸟（Kazooie）这对奇妙的组合，\n活用各自的特征以及各种动作展开一场大冒险。\n为了夺回被邪恶的魔女Gruntilda抓走的Banjo的\n妹妹Tooty，Banjo和Kazooie开始了冒险。\n他们将从“Spiral Mountain”出发，\n路上会有鲨鱼出没的“Treasure Trove Cove”和\n一片雪白的“Freezeezy Peak”等丰富关卡。\n一般情况下，Kazooie会躲在Banjo的蓝色背包中，\n让人感觉两人（两只动物）好像合为一体一样。\n或许会对同伴心生厌烦，但只要2人齐心合力，\n就能越过各种难关。那么，你也快来和两人一起开始冒险吧！
META_TITLE_COMMENT_N_1407_j	林克误入的世界。\n……那便是还有3天就将结束的世界。\n\n本作品发售于2000年，是Nintendo 64上的动作冒险游戏。\n距保护塞尔达公主，并拯救海拉鲁已经过去了数月有余。\n在森林中持续着旅行的林克遇到了戴着诡异面具的小鬼\n“骷髅小子”的袭击，并因此误入了从未见过的世界。\n那是一个三天后“月亮”就会掉落下来，名叫“Termina”的地方。\n在这个神奇的世界当中，每当月亮冲撞地面世界毁灭之际，\n林克就会回到三天前的早上，一切也都将重新来过。\n依靠寄宿在面具中的各种能力以及歌之力，为了拯救Termina，\n林克将开始冒险。在有限的三天内，他能否摆脱这个\n恶梦轮回呢……？
META_TITLE_COMMENT_N_2456_j	冒死之徒再次集结！\n驾驶音速赛车在立体的巡回赛上驰骋。\n\n本作品发售于1998年，是Nintendo 64上的竞速游戏。\n本作是系列的第2款作品。相比于第1作，本作在各个方面\n都有了大幅提升。比如赛道升级成了立体赛道，增加了车辆数量\n以及动作等等。除了主要的GP模式外，还有挑战自己极限的\nTime Attack模式，以及比拼让自己以外所有车辆全部退场所需时间的\nDeath Race模式。要想称霸比赛，就需要熟知赛道上的机关，\n采用适合车辆的行驶路线以及运用相关的技术。
META_TITLE_COMMENT_N_4371_j	与马力欧一起打真正的高尔夫！\n操作简单，大人孩子都能乐在其中。\n\n本作品发售于1999年，是Nintendo 64上的运动游戏。\n马力欧、路易吉、桃花公主等马力欧系列中的那些令人耳熟能详的\n角色都会登场。规则非常简单，就算不了解高尔夫也能玩。\n只要在击球画面中看着力度槽，然后看准时机按键就能打出好球。\n击球前可以详细设置球杆种类及击球点，所以熟悉操作或喜欢玩\n高尔夫的人就一边查看详细信息，一边进行设置并争取获得好成绩吧。\n获得好成绩增加“COURSE Pts”后，就会出现新的场地。\n另外，在“Get Character”中战胜对方后，下次游戏时就能使用该角色。\n还有可供4名玩家对战的“Stroke”和“Club Slots”模式，\n使用“Bets”赌上分数游玩的话，对战也会变得更加激烈。
META_TITLE_COMMENT_N_3052_j	搜索Crystal碎片，变化自如的卡比\n将在众星之间开始大冒险。\n\n本作品发售于2000年，是Nintendo 64上的动作游戏。\n在精灵们的星球“Ripple Star”上突然出现了一片诡异的黑云。\n它是为了来抢夺精灵们的宝物“Crystal”。\n精灵“Ribbon”本想带着Crystal逃走，但却受到黑云的撞击，\nCrystal也因此掉落到了地上。Crystal摔碎后，\n碎片飞向了众星。在“波普之星”上正在仰望星空的卡比\n遇到了跌落至此的Ribbon。为了帮助陷入困境的Ribbon，\n卡比开始了冒险。卡比拥有复制敌人能力的力量，在本作中可以\n通过混合2种能力产生新的能力。方法共有4种，可以撞击拥有\n能力的敌人，也可以同时吸入2个敌人进行复制。\n在“Mini-Games”中，还可以1～4人乐享3种迷你游戏。
META_TITLE_COMMENT_N_3240_j	可以单手乐享照相机的“宝可梦”世界！\n拍摄你自己的最佳照片吧。\n\n本作品发售于1999年，是Nintendo 64上的照相机动作游戏。\n游戏的主人公不是“宝可梦训练家”，而是“宝可梦摄影师”。\n游戏的目的是用照相机拍摄“Pokémon Island”上的宝可梦。\n游戏中将出现60多种“宝可梦”系列中的那些令人熟悉的宝可梦。\n他们会向着镜头摆造型，动作非常丰富，你还可以和它们一起玩耍。\n还能将喜欢的照片保存在“PKMN Album”，并自由添加标注。\n将照片发给大木博士让他帮你打分，增加自己的综合得分后，\n还可以得到会对拍摄很有帮助的“道具”。使用道具后，\n宝可梦的反应会和平时不同，所以获得道具后就多多地使用它们吧。
META_TITLE_COMMENT_N_4093_j	在超高速战斗中获胜，以最强的Commander为目标！\n\n本作品发售于1999年，是Nintendo 64上的机器人动作角色扮演游戏。\n玩家将成为能操纵全长30cm左右的小型机器人“Custom Robo”的\n“commander”，和同伴一起进行冒险。对到手的机器人和零件\n进行改造，以最强的Commander为目标吧。随着“剧情模式”的\n推进，能在“街机模式”中玩的模式和等级也会增加。\n“街机模式”是可以尽情享受对战的模式，除了主人公的爱机\n“Ray”之外，还可以使用在“剧情模式”中对战过的机器人。\n在“剧情模式”结束后，可以在“选项模式”中选择\n是否让违规零件出现在游戏中。
META_TITLE_COMMENT_N_3668_j	自由组合部件，自由组合机器人！\n使用自己的Custom Robo战斗吧。\n\n本作品发售于2000年，是Nintendo 64上的机器人动作角色扮演游戏。\n玩家将扮演操纵全长30cm左右的小型机器人“Custom Robo”的\n“Commander”，与伙伴们一起进行冒险。自由组合获得的\n机器人和部件，成为最强的Commander吧。故事模式分为\n“A New Journey”和“The Grand Battle”两部分。\n在“A New Journey”中将沿着故事情节进行冒险和战斗。\n“The Grand Battle”则有着“Parts Confiscation Battle”、\n“Lended Parts Battle”等特殊的规则，\n能感受到与“A New Journey”不同的乐趣。\n在特定的对战中战胜对手可以获得机器人和部件。可以组合的部分\n共有“Robo”、“Gun”、“Bomb”、“Pod”和“Leg”5种。\n收集部件，自由组合并享受各种战术的乐趣吧。能化为对战场地的\nHolosseum共有40种以上。由于战场上存在各种障碍物和机关，\n墙壁的位置等也不尽相同，因此根据地形制定合理的战术\n是获得胜利的关键。
META_TITLE_COMMENT_N_4813_j	穿梭在波光粼粼的波浪中。\n以水面为舞台的JET SKI竞速游戏。\n\n本作品发售于1996年，是Nintendo 64上的竞速游戏。\n玩家将乘坐可在水上疾驰的JET SKI水上摩托，一边和对手战斗，\n一边比比谁的用时最少及技术更高。可以根据自己的技术及喜好，\n从4种车辆中选择适合自己的车辆，并从“Handling”、\n“Acceleration”、“Grip”这3方面来自行改装。\n游戏共有多种模式，可以享受到多种游戏的乐趣。
META_TITLE_COMMENT_N_3783_j	你能获得天空专家的桂冠吗？\n\n本作品发售于1996年，是Nintendo 64上的天空运动模拟游戏。\n飞行员们可以自由地在空中翱翔。\n在《パイロットウイングス》的世界中，这样的伙伴有很多。\n他们的愿望是获得“飞行员执照”，获取作为天空专家证明的“徽章”。\n为此，需要操纵“HANG GLIDER”、“ROCKET BELT”、\n“GYROCOPTER”这3种机体，完成与各机体级别相对应的\n“任务（课题）”，并通过资格考试。\n当然，作为空中的专家肯定不会只满足于此。\n以前作（Super Famicom版）中那令人熟悉的“SKY DIVING”为首，\n各种各样的机体正等待着飞行员们的挑战。\n在游戏中登场的是特立独行，性格迥异的6名飞行员。\n你将与他们一同在空中翱翔，称霸所有机体与所有级别，\n并获得天空专家的桂冠！
META_TITLE_COMMENT_N_4737_j	以超级明星为目标，人气明星们一起快乐地开派对！\n\n本作品发售于1998年，是Nintendo 64上的聚会游戏。\n崭新的游戏类型“桌游”登场。根据你所到达的方格，\n会随时出现小游戏。熟练地通关小游戏后，能让自己在棋盘上\n变得更加有利。这是以前只会掷骰子的棋盘游戏所没有的，\n能让玩家感受到心跳和刺激。马力欧派对不仅仅是单纯的“桌游”，\n而是包含了各种各样游戏的“派对游戏”。
META_TITLE_COMMENT_N_1053_j	与马力欧他们一起在充满快乐机关的世界中驰骋吧！！\n\n本作品发售于1999年，是Nintendo 64上的聚会游戏。\n马力欧他们倾注了梦想与冒险建成了主题公园。\n就在要给它起名字的时候，酷霸王突然袭击了过来！\n后来，马力欧他们就以打倒酷霸王的无敌星为名，\n将该主题公园命名为了无敌星公园。\n那么，谁会成为闪闪发光的无敌星呢？\n在棋盘上有着很多有趣的事件和迷你游戏。迷你游戏的数量\n竟然达到了64种！种类也有很多，有竞速类，动作类等等。\n“掠夺箱”或“传送砖块”等道具能在棋盘上使用。\n只要活用它们或许就能一举逆转局面……！？
exploded_strings
SYS_DIALOG_GENERIC_BUTTON1	[GENERIC_DIALOG_BUTTON1]
SYS_DIALOG_GENERIC_BUTTON2	[GENERIC_DIALOG_BUTTON2]
SYS_DIALOG_GENERIC_BUTTON3	[GENERIC_DIALOG_BUTTON3]
SYS_DIALOG_EXCHANGE_PLAYER_1P_TEXT	已更换1P和2P。\n您现在是1P。\n[HOST_NAME]将继续进行菜单的操作。
SYS_DIALOG_EXCHANGE_PLAYER_2P_TEXT	已更换1P和2P。\n您现在是2P。\n[HOST_NAME]将继续进行菜单的操作。
SYS_DIALOG_SWAP_PLAYER_TEXT	[NEW_1P_NAME]成为了1P。\n菜单将由[HOST_NAME]继续操作。
SYS_DIALOG_SWAP_PLAYER_TEXT_LONG	[NEW_1P_NAME]成为了1P。\n你现在是[SELF_EMU_INDEX]P。\n菜单将由[HOST_NAME]继续操作。
SYS_DIALOG_ONLINE_CREATE_SESSION_WITH_PASSWORD	[IMG_LOCK]有密码
SYS_DIALOG_ONLINE_WAITING_FOR_GUEST_TEXT	正在与[GUEST_NAME]汇合⋯⋯
SYS_DIALOG_ONLINE_WAITING_FOR_GUEST_4P_TEXT	正在与[JOINNER_NAME]汇合⋯⋯
SYS_DIALOG_ONLINE_WAITING_FOR_HOST_TEXT	正在与[HOST_NAME]汇合⋯⋯\n（您的保存数据不会更改）
SYS_DIALOG_ONLINE_ESTABLISHED_HOST_TEXT	[GUEST_NAME]加入了您的游戏。\n接下来将由[HOST_NAME]进行菜单的操作。\n连接质量取决于您与对方之间的连接环境。
SYS_DIALOG_ONLINE_ESTABLISHED_HOST_4P_TEXT	[JOINNER_NAME]加入了您的游戏。\n接下来将由[HOST_NAME]进行菜单的操作。\n连接质量取决于您与对方之间的连接环境。
SYS_DIALOG_ONLINE_ESTABLISHED_GUEST_TEXT	您加入了[HOST_NAME]的游戏。\n接下来将由[HOST_NAME]进行菜单的操作。\n连接质量取决于您与对方之间的连接环境。
SYS_DIALOG_DURING_GUEST_OPERATION_TEXT	[GUEST_NAME]正在操作⋯⋯
SYS_DIALOG_DURING_GUEST_OPERATION_4P_TEXT	[OWNER_NAME]正在操作⋯⋯
SYS_DIALOG_DURING_HOST_OPERATION_TEXT	[HOST_NAME]正在操作⋯⋯
SYS_DIALOG_ONLINE_PAUSE_ON_DISCONNECT_TEXT	与[GUEST_NAME]的连接已断开。\n接下来将无法继续游戏。\n只能使用随时保存功能。
SYS_HUD_GUIDE_PRO_CONFIRM	[IMG_BUTTON_A]  确定
SYS_HUD_GUIDE_PRO_BACK	[IMG_BUTTON_B]  返回
SYS_HUD_GUIDE_PRO_DETAILS	[IMG_BUTTON_X]  详情
SYS_HUD_GUIDE_PRO_MOVE	[IMG_BUTTON_Y]  移动
SYS_HUD_GUIDE_PRO_MOVE2	[IMG_BUTTON_Y]  移动（长按排序）
SYS_HUD_GUIDE_PRO_SORT	[IMG_BUTTON_Y]  长按排序
SYS_HUD_GUIDE_PRO_PLAY	[IMG_BUTTON_A]  开始
SYS_HUD_GUIDE_PRO_GUIDE	[IMG_BUTTON_X]  操作指南
SYS_HUD_GUIDE_PRO_GUIDE_CHANGE	[IMG_BUTTON_X]  更改操作方法
SYS_HUD_GUIDE_PRO_EXCHANGE	[IMG_BUTTON_Y]  更换1P/2P
SYS_HUD_GUIDE_PRO_SWAP	[IMG_BUTTON_Y]  更换1P
SYS_HUD_GUIDE_PRO_VOICE_CHAT	[IMG_BUTTON_X]  如何进行语音聊天？
SYS_HUD_GUIDE_PRO_INGAME_PAUSE	[IMG_BUTTON_ZL] + [IMG_BUTTON_ZR]  暂停菜单
SYS_HUD_GUIDE_PRO_INGAME_PAUSE2	[IMG_BUTTON_MINUS]  暂停菜单
SYS_HUD_GUIDE_PRO_INGAME_START	[IMG_BUTTON_PLUS]  START键
SYS_HUD_GUIDE_PRO_INGAME_SELECT	[IMG_BUTTON_MINUS]  SELECT键
SYS_HUD_GUIDE_PRO_INGAME_QUIT_ONLINE	[IMG_BUTTON_ZL] + [IMG_BUTTON_ZR]  退出线上游戏
SYS_HUD_GUIDE_PRO_DETAILES_NEXT	[IMG_BUTTON_A]  继续
SYS_HUD_GUIDE_PRO_DETAILES_NEXT2	[IMG_BUTTON_X]  继续
SYS_HUD_GUIDE_PRO_COMMIT	[IMG_BUTTON_Y]  确定
SYS_HUD_GUIDE_PRO_CANCEL	[IMG_BUTTON_B]  复原
SYS_HUD_GUIDE_PRO_NETPLAY_OPTIONAL_MODE	[IMG_BUTTON_Y]  开启低延迟连接模式
SYS_HUD_GUIDE_PRO_NETPLAY_PRIMARY_MODE	[IMG_BUTTON_Y]  关闭低延迟连接模式
SYS_HUD_GUIDE_JOY_L_CONFIRM	[IMG_BUTTON_CLOVER_R]  确定
SYS_HUD_GUIDE_JOY_R_CONFIRM	[IMG_BUTTON_CLOVER_R]  确定
SYS_HUD_GUIDE_JOY_L_BACK	[IMG_BUTTON_CLOVER_D]  返回
SYS_HUD_GUIDE_JOY_R_BACK	[IMG_BUTTON_CLOVER_D]  返回
SYS_HUD_GUIDE_JOY_L_DETAILS	[IMG_BUTTON_CLOVER_U]  详情
SYS_HUD_GUIDE_JOY_R_DETAILS	[IMG_BUTTON_CLOVER_U]  详情
SYS_HUD_GUIDE_JOY_L_MOVE	[IMG_BUTTON_CLOVER_L]  移动
SYS_HUD_GUIDE_JOY_L_MOVE2	[IMG_BUTTON_CLOVER_L]  移动（长按排序）
SYS_HUD_GUIDE_JOY_L_SORT	[IMG_BUTTON_CLOVER_L]  长按排序
SYS_HUD_GUIDE_JOY_R_MOVE	[IMG_BUTTON_CLOVER_L]  移动
SYS_HUD_GUIDE_JOY_R_MOVE2	[IMG_BUTTON_CLOVER_L]  移动（长按排序）
SYS_HUD_GUIDE_JOY_R_SORT	[IMG_BUTTON_CLOVER_L]  长按排序
SYS_HUD_GUIDE_JOY_L_PLAY	[IMG_BUTTON_CLOVER_R]  开始
SYS_HUD_GUIDE_JOY_R_PLAY	[IMG_BUTTON_CLOVER_R]  开始
SYS_HUD_GUIDE_JOY_L_GUIDE	[IMG_BUTTON_CLOVER_U]  操作指南
SYS_HUD_GUIDE_JOY_L_GUIDE_CHANGE	[IMG_BUTTON_CLOVER_U]  更改操作方法
SYS_HUD_GUIDE_JOY_R_GUIDE	[IMG_BUTTON_CLOVER_U]  操作指南
SYS_HUD_GUIDE_JOY_R_GUIDE_CHANGE	[IMG_BUTTON_CLOVER_U]  更改操作方法
SYS_HUD_GUIDE_JOY_L_EXCHANGE	[IMG_BUTTON_CLOVER_L]  更换1P/2P
SYS_HUD_GUIDE_JOY_L_SWAP	[IMG_BUTTON_CLOVER_L]  更换1P
SYS_HUD_GUIDE_JOY_R_EXCHANGE	[IMG_BUTTON_CLOVER_L]  更换1P/2P
SYS_HUD_GUIDE_JOY_R_SWAP	[IMG_BUTTON_CLOVER_L]  更换1P
SYS_HUD_GUIDE_JOY_L_VOICE_CHAT	[IMG_BUTTON_CLOVER_U]  如何进行语音聊天？
SYS_HUD_GUIDE_JOY_R_VOICE_CHAT	[IMG_BUTTON_CLOVER_U]  如何进行语音聊天？
SYS_HUD_GUIDE_JOY_L_INGAME_PAUSE	[IMG_BUTTON_MINUS] + [IMG_BUTTON_ZL]  暂停菜单
SYS_HUD_GUIDE_JOY_R_INGAME_PAUSE	[IMG_BUTTON_PLUS] + [IMG_BUTTON_ZR]  暂停菜单
SYS_HUD_GUIDE_JOY_L_INGAME_START	[IMG_BUTTON_MINUS] + [IMG_BUTTON_SR]  START键
SYS_HUD_GUIDE_JOY_L_INGAME_START_01	[IMG_BUTTON_MINUS] + [IMG_BUTTON_LT]  START键
SYS_HUD_GUIDE_JOY_R_INGAME_START	[IMG_BUTTON_PLUS] + [IMG_BUTTON_SR]  START键
SYS_HUD_GUIDE_JOY_R_INGAME_START_01	[IMG_BUTTON_PLUS] + [IMG_BUTTON_RT]  START键
SYS_HUD_GUIDE_JOY_L_INGAME_SELECT	[IMG_BUTTON_MINUS] + [IMG_BUTTON_SL]  SELECT键
SYS_HUD_GUIDE_JOY_R_INGAME_SELECT	[IMG_BUTTON_PLUS] + [IMG_BUTTON_SL]  SELECT键
SYS_HUD_GUIDE_JOY_L_INGAME_QUIT_ONLINE	[IMG_BUTTON_MINUS] + [IMG_BUTTON_ZL]  退出线上游戏
SYS_HUD_GUIDE_JOY_R_INGAME_QUIT_ONLINE	[IMG_BUTTON_PLUS] + [IMG_BUTTON_ZR]  退出线上游戏
SYS_HUD_GUIDE_JOY_L_DETAILS_NEXT	[IMG_BUTTON_CLOVER_R]  继续
SYS_HUD_GUIDE_JOY_R_DETAILS_NEXT	[IMG_BUTTON_CLOVER_R]  继续
SYS_HUD_GUIDE_JOY_L_COMMIT	[IMG_BUTTON_CLOVER_L]  确定
SYS_HUD_GUIDE_JOY_R_COMMIT	[IMG_BUTTON_CLOVER_L]  确定
SYS_HUD_GUIDE_JOY_L_CANCEL	[IMG_BUTTON_CLOVER_D]  复原
SYS_HUD_GUIDE_JOY_R_CANCEL	[IMG_BUTTON_CLOVER_D]  复原
SYS_HUD_GUIDE_JOY_L_NETPLAY_OPTIONAL_MODE	[IMG_BUTTON_CLOVER_L]  开启低延迟连接模式
SYS_HUD_GUIDE_JOY_R_NETPLAY_OPTIONAL_MODE	[IMG_BUTTON_CLOVER_L]  开启低延迟连接模式
SYS_HUD_GUIDE_JOY_L_NETPLAY_PRIMARY_MODE	[IMG_BUTTON_CLOVER_L]  关闭低延迟连接模式
SYS_HUD_GUIDE_JOY_R_NETPLAY_PRIMARY_MODE	[IMG_BUTTON_CLOVER_L]  关闭低延迟连接模式
SYS_HUD_GUIDE_LARK_HOME	[IMG_BUTTON_LARK_RT]  HOME菜单
SYS_HUD_GUIDE_LARK_HOME2	[IMG_BUTTON_LARK_RT] : [IMG_BUTTON_HOME]
SYS_HUD_GUIDE_LARK_R_HOME	[IMG_BUTTON_LARK_RIGHT_DPAD]  HOME菜单
SYS_HUD_GUIDE_LARK_R_HOME2	[IMG_BUTTON_LARK_RIGHT_DPAD] : [IMG_BUTTON_HOME]
SYS_HUD_GUIDE_LUCIA_HOME	[IMG_BUTTON_LUCIA_ZR]  HOME菜单
SYS_HUD_GUIDE_LUCIA_HOME2	[IMG_BUTTON_LUCIA_ZR] : [IMG_BUTTON_HOME]
SYS_HUD_GUIDE_LARK_CAPTURE	[IMG_BUTTON_LARK_LT]  截图
SYS_HUD_GUIDE_LARK_CAPTURE2	[IMG_BUTTON_LARK_LT] : [IMG_BUTTON_CAPTURE]
SYS_HUD_GUIDE_LARK_L_CAPTURE	[IMG_BUTTON_LARK_LEFT_A]  截图
SYS_HUD_GUIDE_LARK_L_CAPTURE2	[IMG_BUTTON_LARK_LEFT_A] : [IMG_BUTTON_CAPTURE]
SYS_HUD_GUIDE_LUCIA_CAPTURE	[IMG_BUTTON_LUCIA_ZL]  截图
SYS_HUD_GUIDE_LUCIA_CAPTURE2	[IMG_BUTTON_LUCIA_ZL] : [IMG_BUTTON_CAPTURE]
SYS_HUD_GUIDE_LARK_CONFIRM	[IMG_BUTTON_A]  确定
SYS_HUD_GUIDE_LARK_BACK	[IMG_BUTTON_B]  返回
SYS_HUD_GUIDE_LARK_DETAILS	[IMG_BUTTON_LARK_START]  详情
SYS_HUD_GUIDE_LARK_MOVE	[IMG_BUTTON_LARK_SELECT]  移动
SYS_HUD_GUIDE_LARK_MOVE2	[IMG_BUTTON_LARK_SELECT]  移动（长按排序）
SYS_HUD_GUIDE_LARK_SORT	[IMG_BUTTON_LARK_SELECT]  长按排序
SYS_HUD_GUIDE_LARK_PLAY	[IMG_BUTTON_A]  开始
SYS_HUD_GUIDE_LARK_GUIDE	[IMG_BUTTON_LARK_START]  操作指南
SYS_HUD_GUIDE_LARK_EXCHANGE	[IMG_BUTTON_LARK_SELECT]  更换1P/2P
SYS_HUD_GUIDE_LARK_VOICE_CHAT	[IMG_BUTTON_LARK_START]  如何进行语音聊天？
SYS_HUD_GUIDE_LARK_INGAME_PAUSE	[IMG_BUTTON_LARK_LT] + [IMG_BUTTON_LARK_RT]  暂停菜单
SYS_HUD_GUIDE_LARK_INGAME_QUIT_ONLINE	[IMG_BUTTON_LARK_LT] + [IMG_BUTTON_LARK_RT]  退出线上游戏
SYS_HUD_GUIDE_LARK_DETAILES_NEXT	[IMG_BUTTON_A]  继续
SYS_HUD_GUIDE_LARK_COMMIT	[IMG_BUTTON_LARK_SELECT]  确定
SYS_HUD_GUIDE_LARK_CANCEL	[IMG_BUTTON_B]  复原
SYS_HUD_GUIDE_LARK_NETPLAY_OPTIONAL_MODE	[IMG_BUTTON_LARK_SELECT]  开启低延迟连接模式
SYS_HUD_GUIDE_LARK_NETPLAY_PRIMARY_MODE	[IMG_BUTTON_LARK_SELECT]  关闭低延迟连接模式
SYS_HUD_GUIDE_LARK_L_CONFIRM	[IMG_BUTTON_A]  确定
SYS_HUD_GUIDE_LARK_L_BACK	[IMG_BUTTON_B]  返回
SYS_HUD_GUIDE_LARK_L_DETAILS	[IMG_BUTTON_X]  详情
SYS_HUD_GUIDE_LARK_L_MOVE	[IMG_BUTTON_Y]  移动
SYS_HUD_GUIDE_LARK_L_MOVE2	[IMG_BUTTON_Y]  移动（长按排序）
SYS_HUD_GUIDE_LARK_L_SORT	[IMG_BUTTON_Y]  长按排序
SYS_HUD_GUIDE_LARK_L_PLAY	[IMG_BUTTON_A]  开始
SYS_HUD_GUIDE_LARK_L_GUIDE	[IMG_BUTTON_X]  操作指南
SYS_HUD_GUIDE_LARK_L_EXCHANGE	[IMG_BUTTON_Y]  更换1P/2P
SYS_HUD_GUIDE_LARK_L_SWAP	[IMG_BUTTON_Y]  更换1P
SYS_HUD_GUIDE_LARK_L_VOICE_CHAT	[IMG_BUTTON_X]  如何进行语音聊天？
SYS_HUD_GUIDE_LARK_L_INGAME_PAUSE	[IMG_BUTTON_LARK_LEFT_B]  暂停菜单
SYS_HUD_GUIDE_LARK_L_INGAME_START	[IMG_BUTTON_LARK_START]  START键
SYS_HUD_GUIDE_LARK_L_INGAME_SELECT	[IMG_BUTTON_LARK_SELECT]  SELECT键
SYS_HUD_GUIDE_LARK_L_INGAME_QUIT_ONLINE	[IMG_BUTTON_LARK_LEFT_B]  退出线上游戏
SYS_HUD_GUIDE_LARK_L_DETAILES_NEXT	[IMG_BUTTON_A]  继续
SYS_HUD_GUIDE_LARK_L_COMMIT	[IMG_BUTTON_Y]  确定
SYS_HUD_GUIDE_LARK_L_CANCEL	[IMG_BUTTON_B]  复原
SYS_HUD_GUIDE_LARK_L_NETPLAY_OPTIONAL_MODE	[IMG_BUTTON_Y]  开启低延迟连接模式
SYS_HUD_GUIDE_LARK_L_NETPLAY_PRIMARY_MODE	[IMG_BUTTON_Y]  关闭低延迟连接模式
SYS_HUD_GUIDE_LARK_R_CONFIRM	[IMG_BUTTON_LARK_RIGHT_A]  确定
SYS_HUD_GUIDE_LARK_R_BACK	[IMG_BUTTON_LARK_RIGHT_B]  返回
SYS_HUD_GUIDE_LARK_R_DETAILS	[IMG_BUTTON_CLOVER_R]  详情
SYS_HUD_GUIDE_LARK_R_MOVE	[IMG_BUTTON_CLOVER_U]  移动
SYS_HUD_GUIDE_LARK_R_MOVE2	[IMG_BUTTON_CLOVER_U]  移动（长按排序）
SYS_HUD_GUIDE_LARK_R_SORT	[IMG_BUTTON_CLOVER_U]  长按排序
SYS_HUD_GUIDE_LARK_R_PLAY	[IMG_BUTTON_LARK_RIGHT_A]  开始
SYS_HUD_GUIDE_LARK_R_GUIDE	[IMG_BUTTON_CLOVER_R]  操作指南
SYS_HUD_GUIDE_LARK_R_EXCHANGE	[IMG_BUTTON_CLOVER_U]  更换1P/2P
SYS_HUD_GUIDE_LARK_R_SWAP	[IMG_BUTTON_CLOVER_U]  更换1P
SYS_HUD_GUIDE_LARK_R_VOICE_CHAT	[IMG_BUTTON_CLOVER_R]  如何进行语音聊天？
SYS_HUD_GUIDE_LARK_R_INGAME_PAUSE	[IMG_BUTTON_CLOVER_D]  暂停菜单
SYS_HUD_GUIDE_LARK_R_INGAME_START	[IMG_BUTTON_CLOVER_R]  START键
SYS_HUD_GUIDE_LARK_R_INGAME_SELECT	[IMG_BUTTON_CLOVER_U]  SELECT键
SYS_HUD_GUIDE_LARK_R_INGAME_QUIT_ONLINE	[IMG_BUTTON_CLOVER_D]  退出线上游戏
SYS_HUD_GUIDE_LARK_R_DETAILES_NEXT	[IMG_BUTTON_LARK_RIGHT_A]  继续
SYS_HUD_GUIDE_LARK_R_COMMIT	[IMG_BUTTON_CLOVER_U]  确定
SYS_HUD_GUIDE_LARK_R_CANCEL	[IMG_BUTTON_LARK_RIGHT_B]  复原
SYS_HUD_GUIDE_LARK_R_NETPLAY_OPTIONAL_MODE	[IMG_BUTTON_CLOVER_U]  开启低延迟连接模式
SYS_HUD_GUIDE_LARK_R_NETPLAY_PRIMARY_MODE	[IMG_BUTTON_CLOVER_U]  关闭低延迟连接模式
SYS_HUD_GUIDE_LARK_LR_CONFIRM	[IMG_BUTTON_LARK_RIGHT_A]  确定
SYS_HUD_GUIDE_LARK_LR_BACK	[IMG_BUTTON_LARK_RIGHT_B]  返回
SYS_HUD_GUIDE_LARK_LR_DETAILS	[IMG_BUTTON_LARK_START]  详情
SYS_HUD_GUIDE_LARK_LR_MOVE	[IMG_BUTTON_LARK_SELECT]  移动
SYS_HUD_GUIDE_LARK_LR_MOVE2	[IMG_BUTTON_LARK_SELECT]  移动（长按排序）
SYS_HUD_GUIDE_LARK_LR_SORT	[IMG_BUTTON_LARK_SELECT]  长按排序
SYS_HUD_GUIDE_LARK_LR_PLAY	[IMG_BUTTON_LARK_RIGHT_A]  开始
SYS_HUD_GUIDE_LARK_LR_GUIDE	[IMG_BUTTON_LARK_START]  操作指南
SYS_HUD_GUIDE_LARK_LR_EXCHANGE	[IMG_BUTTON_LARK_SELECT]  更换1P/2P
SYS_HUD_GUIDE_LARK_LR_SWAP	[IMG_BUTTON_LARK_SELECT]  更换1P
SYS_HUD_GUIDE_LARK_LR_VOICE_CHAT	[IMG_BUTTON_LARK_START]  如何进行语音聊天？
SYS_HUD_GUIDE_LARK_LR_INGAME_PAUSE	[IMG_BUTTON_LARK_LEFT_B]  暂停菜单
SYS_HUD_GUIDE_LARK_LR_INGAME_START	[IMG_BUTTON_LARK_START]  START键
SYS_HUD_GUIDE_LARK_LR_INGAME_SELECT	[IMG_BUTTON_LARK_SELECT]  SELECT键
SYS_HUD_GUIDE_LARK_LR_INGAME_QUIT_ONLINE	[IMG_BUTTON_LARK_LEFT_B]  退出线上游戏
SYS_HUD_GUIDE_LARK_LR_DETAILES_NEXT	[IMG_BUTTON_LARK_RIGHT_A]  继续
SYS_HUD_GUIDE_LARK_LR_COMMIT	[IMG_BUTTON_LARK_SELECT]  确定
SYS_HUD_GUIDE_LARK_LR_CANCEL	[IMG_BUTTON_LARK_RIGHT_B]  复原
SYS_HUD_GUIDE_LARK_LR_NETPLAY_OPTIONAL_MODE	[IMG_BUTTON_LARK_SELECT]  开启低延迟连接模式
SYS_HUD_GUIDE_LARK_LR_NETPLAY_PRIMARY_MODE	[IMG_BUTTON_LARK_SELECT]  关闭低延迟连接模式
SYS_HUD_GUIDE_LUCIA_CONFIRM	[IMG_BUTTON_A]  确定
SYS_HUD_GUIDE_LUCIA_BACK	[IMG_BUTTON_B]  返回
SYS_HUD_GUIDE_LUCIA_DETAILS	[IMG_BUTTON_X]  详情
SYS_HUD_GUIDE_LUCIA_MOVE	[IMG_BUTTON_Y]  移动
SYS_HUD_GUIDE_LUCIA_MOVE2	[IMG_BUTTON_Y]  移动（长按排序）
SYS_HUD_GUIDE_LUCIA_SORT	[IMG_BUTTON_Y]  长按排序
SYS_HUD_GUIDE_LUCIA_PLAY	[IMG_BUTTON_A]  开始
SYS_HUD_GUIDE_LUCIA_GUIDE	[IMG_BUTTON_X]  操作指南
SYS_HUD_GUIDE_LUCIA_EXCHANGE	[IMG_BUTTON_Y]  更换1P/2P
SYS_HUD_GUIDE_LUCIA_SWAP	[IMG_BUTTON_Y]  更换1P
SYS_HUD_GUIDE_LUCIA_VOICE_CHAT	[IMG_BUTTON_X]  如何进行语音聊天？
SYS_HUD_GUIDE_LUCIA_INGAME_PAUSE	[IMG_BUTTON_LUCIA_ZL] + [IMG_BUTTON_LUCIA_ZR]  暂停菜单
SYS_HUD_GUIDE_LUCIA_INGAME_QUIT_ONLINE	[IMG_BUTTON_LUCIA_ZL] + [IMG_BUTTON_LUCIA_ZR]  退出线上游戏
SYS_HUD_GUIDE_LUCIA_DETAILES_NEXT	[IMG_BUTTON_A]  继续
SYS_HUD_GUIDE_LUCIA_COMMIT	[IMG_BUTTON_Y]  确定
SYS_HUD_GUIDE_LUCIA_CANCEL	[IMG_BUTTON_B]  复原
SYS_HUD_GUIDE_LUCIA_NETPLAY_OPTIONAL_MODE	[IMG_BUTTON_Y]  开启低延迟连接模式
SYS_HUD_GUIDE_LUCIA_NETPLAY_PRIMARY_MODE	[IMG_BUTTON_Y]  关闭低延迟连接模式
SYS_HUD_GUIDE_LARK3_CONFIRM	[IMG_BUTTON_A]  确定
SYS_HUD_GUIDE_LARK3_BACK	[IMG_BUTTON_B]  返回
SYS_HUD_GUIDE_LARK3_DETAILS	[IMG_BUTTON_C_UP]  详情
SYS_HUD_GUIDE_LARK3_MOVE	[IMG_BUTTON_C_LEFT]  移动
SYS_HUD_GUIDE_LARK3_MOVE2	[IMG_BUTTON_C_LEFT]  移动（长按排序）
SYS_HUD_GUIDE_LARK3_SORT	[IMG_BUTTON_C_LEFT]  长按排序
SYS_HUD_GUIDE_LARK3_PLAY	[IMG_BUTTON_A]  开始
SYS_HUD_GUIDE_LARK3_GUIDE	[IMG_BUTTON_C_UP]  操作指南
SYS_HUD_GUIDE_LARK3_EXCHANGE	[IMG_BUTTON_C_LEFT]  更换1P/2P
SYS_HUD_GUIDE_LARK3_SWAP	[IMG_BUTTON_C_LEFT]  更换1P
SYS_HUD_GUIDE_LARK3_VOICE_CHAT	[IMG_BUTTON_C_UP]  如何进行语音聊天？
SYS_HUD_GUIDE_LARK3_INGAME_PAUSE	[IMG_BUTTON_LUCIA_ZR]  暂停菜单
SYS_HUD_GUIDE_LARK3_INGAME_QUIT_ONLINE	[IMG_BUTTON_LUCIA_ZR]  退出线上游戏
SYS_HUD_GUIDE_PRO_INGAME_QUIT_ONLINE2	[IMG_BUTTON_MINUS]  退出线上游戏
SYS_HUD_GUIDE_LARK3_DETAILES_NEXT	[IMG_BUTTON_A]  继续
SYS_HUD_GUIDE_LARK3_COMMIT	[IMG_BUTTON_C_LEFT]  确定
SYS_HUD_GUIDE_LARK3_CANCEL	[IMG_BUTTON_B]  复原
SYS_HUD_GUIDE_LARK3_NETPLAY_OPTIONAL_MODE	[IMG_BUTTON_C_LEFT]  开启低延迟连接模式
SYS_HUD_GUIDE_LARK3_NETPLAY_PRIMARY_MODE	[IMG_BUTTON_C_LEFT]  关闭低延迟连接模式
SYS_HUD_GUIDE_LARK3_INGAME_SELECT	[IMG_BUTTON_Z]  SELECT键
SYS_INFO_NICKNAME_OWN	[OWN_NAME]
SYS_INFO_NICKNAME_HOST	[HOST_NAME]
SYS_INFO_NICKNAME_GUEST	[GUEST_NAME]
SYS_INFO_NICKNAME_PLAYER2	[PLAYER2_NAME]
SYS_INFO_NICKNAME_PLAYER3	[PLAYER3_NAME]
SYS_INFO_NICKNAME_PLAYER4	[PLAYER4_NAME]
SYS_INFO_SESSION_PASSWORD	[PASSWORD]
SYS_INFO_NETWORK_UNSTABLE	可以在“[IMG_SETTINGS] 设置”中更改连接模式
SYS_MENU_ROOT_SESSION_COUNTER	[NUMBER_OF_SESSIONS]
SYS_MENU_ONLINE_ITEM_SESSION1	[ROOM1]
SYS_MENU_ONLINE_ITEM_SESSION2	[ROOM2]
SYS_MENU_ONLINE_ITEM_SESSION3	[ROOM3]
SYS_MENU_ONLINE_ITEM_SESSION4	[ROOM4]
SYS_MENU_ONLINE_ITEM_SESSION5	[ROOM5]
SYS_MENU_ONLINE_ITEM_SESSION6	[ROOM6]
SYS_MENU_ONLINE_DESC_SESSION_LIST	选择一起玩游戏的好友 [IMG_BUTTON_Y] 重新搜索
SYS_MENU_ONLINE_DESC_SESSION_LIST_JOY_L	选择一起玩游戏的好友 [IMG_BUTTON_CLOVER_L] 重新搜索
SYS_MENU_ONLINE_DESC_SESSION_LIST_JOY_R	选择一起玩游戏的好友 [IMG_BUTTON_CLOVER_L] 重新搜索
SYS_MENU_ONLINE_DESC_SESSION_LIST_LARK	选择一起玩游戏的好友 [IMG_BUTTON_LARK_SELECT] 重新搜索
SYS_MENU_ONLINE_DESC_SESSION_LIST_LARK_L	选择一起玩游戏的好友 [IMG_BUTTON_Y] 重新搜索
SYS_MENU_ONLINE_DESC_SESSION_LIST_LARK_R	选择一起玩游戏的好友 [IMG_BUTTON_CLOVER_U] 重新搜索
SYS_MENU_ONLINE_DESC_SESSION_LIST_LARK_LR	选择一起玩游戏的好友 [IMG_BUTTON_LARK_SELECT] 重新搜索
SYS_MENU_ONLINE_DESC_SESSION_LIST_LUCIA	选择一起玩游戏的好友 [IMG_BUTTON_Y] 重新搜索
SYS_MENU_ONLINE_DESC_SESSION_LIST_LARK3	选择一起玩游戏的好友 [IMG_BUTTON_C_LEFT] 重新搜索
SYS_MENU_ONLINE_DESC_SESSION_LIST_INVITE	选择要汇合的好友 [IMG_BUTTON_Y] 重新搜索
SYS_MENU_ONLINE_DESC_SESSION_LIST_JOY_L_INVITE	选择要汇合的好友 [IMG_BUTTON_CLOVER_L] 重新搜索
SYS_MENU_ONLINE_DESC_SESSION_LIST_JOY_R_INVITE	选择要汇合的好友 [IMG_BUTTON_CLOVER_L] 重新搜索
SYS_MENU_ONLINE_DESC_SESSION_LIST_LARK_INVITE	选择要汇合的好友 [IMG_BUTTON_LARK_SELECT] 重新搜索
SYS_MENU_ONLINE_DESC_SESSION_LIST_LARK_L_INVITE	选择要汇合的好友 [IMG_BUTTON_Y] 重新搜索
SYS_MENU_ONLINE_DESC_SESSION_LIST_LARK_R_INVITE	选择要汇合的好友 [IMG_BUTTON_CLOVER_U] 重新搜索
SYS_MENU_ONLINE_DESC_SESSION_LIST_LARK_LR_INVITE	选择要汇合的好友 [IMG_BUTTON_LARK_SELECT] 重新搜索
SYS_MENU_ONLINE_DESC_SESSION_LIST_LUCIA_INVITE	选择要汇合的好友 [IMG_BUTTON_Y] 重新搜索
SYS_MENU_ONLINE_DESC_SESSION_LIST_LARK3_INVITE	选择要汇合的好友 [IMG_BUTTON_C_LEFT] 重新搜索
SYS_MENU_PAUSE_SWAPPLAYER_1	[SWAP_PLAYER_NAME_1]
SYS_MENU_PAUSE_SWAPPLAYER_2	[SWAP_PLAYER_NAME_2]
SYS_MENU_PAUSE_SWAPPLAYER_3	[SWAP_PLAYER_NAME_3]
SYS_MENU_DETAILS_DESC_RELEASE_INFO	[DETAILED_COMPANY]　　[DETAILED_RELEASE_YEAR]年发售
SYS_MENU_DETAILS_DESC_PLAY_INFO_LONG_TIME	游戏人数：[DETAILED_PLAYERS]人　　游戏时间：[DETAILED_PLAYTIME]小时[DETAILED_PLAYTIME_MIN]分钟
SYS_MENU_DETAILS_DESC_PLAY_INFO_SHORT_TIME	游戏人数：[DETAILED_PLAYERS]人　　游戏时间：[DETAILED_PLAYTIME_MIN]分钟
SYS_MENU_DETAILS_DESC_PLAY_INFO_NO_TIME	游戏人数：[DETAILED_PLAYERS]人
SYS_MENU_DETAILS_DESC_PLAY_COUNT	プレイ回数：[DETAILED_PLAYCOUNT]回
SYS_MENU_DETAILS_DESC_PLAY_TIME_SHORT	プレイ時間：[DETAILED_PLAYTIME_MIN]分
SYS_MENU_DETAILS_DESC_PLAY_TIME_LONG	プレイ時間：[DETAILED_PLAYTIME]時間[DETAILED_PLAYTIME_MIN]分
SYS_MENU_DETAIL_PAGE	[DETAIL_NOW_PAGE] / [DETAIL_ALL_PAGE]
SYS_MENU_SAVESLOT_ITEM_EMPTY	保存数据[SAVE_INDEX]
SYS_MENU_SAVESLOT_ITEM_VALID	保存数据[SAVE_INDEX]\n[SAVE_YEAR]/[SAVE_MONTH]/[SAVE_DAY] [SAVE_HOUR]:[SAVE_MINUTE]
SYS_MENU_SPECIAL2_TEXT	SPECIAL[NUMBER]
SYS_MENU_FRIENDPRESENCE	正在游玩：[FRIENDPRESENCE_TITLENAME]
SYS_NOTIFICATION_OTHER_PLAYER_MISSING_TEXT	与[GUEST_NAME]的连接已断开。\n将一边游玩一边等待好友的加入。
SYS_NOTIFICATION_OTHER_PLAYER_MISSING_4P_TEXT	与[LEAVER_NAME]的连接已断开。\n将继续边游玩边等待好友的加入。
SYS_NOTIFICATION_OTHER_PLAYER_MISSING_4P_TEXT_GUEST	与[LEAVER_NAME]的连接已断开。
SYS_NOTIFICATION_OTHER_PLAYER_MISSING2_TEXT	与[HOST_NAME]的连接已断开。
SYS_NOTIFICATION_UNSTABLE_NETWORK_TEXT	由于您与对方的连接不稳定，可能无法流畅地进行游戏。\n可以在“[IMG_SETTINGS_L] 设置”中更改连接模式。
SYS_NOTIFICATION_OPERATION_DENIED_TEXT	[HOST_NAME]正在操作⋯⋯
SYS_NOTIFICATION_OPERATION_DENIED2_TEXT	[GUEST_NAME]正在操作⋯⋯
SYS_POPUP_GUIDE_PRO_CONTROLLER_SELECT	按[IMG_BUTTON_MINUS]键移动光标
SYS_POPUP_GUIDE_PRO_CONTROLLER_START	按[IMG_BUTTON_PLUS]键开始游戏
SYS_POPUP_GUIDE_JOY_L_CONTROLLER_SELECT	[IMG_BUTTON_MINUS] + [IMG_BUTTON_SL]移动光标
SYS_POPUP_GUIDE_JOY_L_CONTROLLER_START	[IMG_BUTTON_MINUS] + [IMG_BUTTON_SR]开始游戏
SYS_POPUP_GUIDE_JOY_L_CONTROLLER_START_01	[IMG_BUTTON_MINUS] + [IMG_BUTTON_LT]开始游戏
SYS_POPUP_GUIDE_JOY_R_CONTROLLER_SELECT	[IMG_BUTTON_PLUS] + [IMG_BUTTON_SL]移动光标
SYS_POPUP_GUIDE_JOY_R_CONTROLLER_START	[IMG_BUTTON_PLUS] + [IMG_BUTTON_SR]开始游戏
SYS_POPUP_GUIDE_JOY_R_CONTROLLER_START_01	[IMG_BUTTON_PLUS] + [IMG_BUTTON_RT]开始游戏
SYS_POPUP_GUIDE_LARK_L_CONTROLLER_SELECT	按[IMG_BUTTON_LARK_SELECT]键移动光标
SYS_POPUP_GUIDE_LARK_L_CONTROLLER_START	按[IMG_BUTTON_LARK_START]键开始游戏
SYS_POPUP_GUIDE_LARK_R_CONTROLLER_SELECT	按[IMG_BUTTON_CLOVER_U]键移动光标
SYS_POPUP_GUIDE_LARK_R_CONTROLLER_START	按[IMG_BUTTON_CLOVER_R]键开始游戏
SYS_POPUP_GUIDE_PRO_PAUSE_MENU	[IMG_BUTTON_ZL] + [IMG_BUTTON_ZR]暂停游戏
SYS_POPUP_GUIDE_PRO_PAUSE_MENU_01	[IMG_BUTTON_MINUS]暂停游戏
SYS_POPUP_GUIDE_JOY_L_PAUSE_MENU	[IMG_BUTTON_MINUS] + [IMG_BUTTON_ZL]暂停游戏
SYS_POPUP_GUIDE_JOY_R_PAUSE_MENU	[IMG_BUTTON_PLUS] + [IMG_BUTTON_ZR]暂停游戏
SYS_POPUP_GUIDE_LARK_PAUSE_MENU	[IMG_BUTTON_LARK_LT] + [IMG_BUTTON_LARK_RT]暂停游戏
SYS_POPUP_GUIDE_LARK_L_PAUSE_MENU	按[IMG_BUTTON_LARK_LEFT_B]键暂停游戏
SYS_POPUP_GUIDE_LARK_R_PAUSE_MENU	按[IMG_BUTTON_CLOVER_D]键暂停游戏
SYS_POPUP_GUIDE_LUCIA_PAUSE_MENU	[IMG_BUTTON_LUCIA_ZL] + [IMG_BUTTON_LUCIA_ZR]暂停游戏
SYS_POPUP_GUIDE_LARK3_PAUSE_MENU	按[IMG_BUTTON_LUCIA_ZR]键暂停游戏
SYS_POPUP_GUIDE_PRO_SWAP_PLAYERS	在暂停菜单按[IMG_BUTTON_Y]键更换1P/2P
SYS_POPUP_GUIDE_JOY_L_SWAP_PLAYERS	在暂停菜单按[IMG_BUTTON_CLOVER_L]键更换1P/2P
SYS_POPUP_GUIDE_JOY_R_SWAP_PLAYERS	在暂停菜单按[IMG_BUTTON_CLOVER_L]键更换1P/2P
SYS_POPUP_GUIDE_FINGER_CURSOR	用[IMG_GAMEPAD_STICK_R]移动手掌光标、用[IMG_BUTTON_STICK_R]（按下）拍手
SYS_POPUP_GUIDE_FINGER_CURSOR_01	按住[IMG_BUTTON_ZR]后再按[IMG_GAMEPAD_STICK_R]为手掌光标，按下[IMG_BUTTON_STICK_R]为拍手
SYS_POPUP_GUIDE_LARK_SYSTEM_BUTTON_HOME	按[IMG_BUTTON_LARK_RT]键前往HOME菜单
SYS_POPUP_GUIDE_LARK_SYSTEM_BUTTON_CAPTURE	按[IMG_BUTTON_LARK_LT]键截图
SYS_POPUP_GUIDE_LARK_R_SYSTEM_BUTTON_HOME	按[IMG_BUTTON_LARK_RIGHT_DPAD]键前往HOME菜单
SYS_POPUP_GUIDE_LARK_L_SYSTEM_BUTTON_CAPTURE	按[IMG_BUTTON_LARK_LEFT_A]键截图
SYS_POPUP_GUIDE_LUCIA_SYSTEM_BUTTON_HOME	按[IMG_BUTTON_LUCIA_ZR]键前往HOME菜单
SYS_POPUP_GUIDE_LUCIA_SYSTEM_BUTTON_CAPTURE	按[IMG_BUTTON_LUCIA_ZL]键截图
SYS_POPUP_GUIDE_PRO_CONTROLGUIDE	在暂停菜单中按[IMG_BUTTON_X]键\n可以确认按键配置。
SYS_POPUP_GUIDE_JOY_L_CONTROLGUIDE	在暂停菜单中按[IMG_BUTTON_CLOVER_U]键\n可以确认按键配置。
SYS_POPUP_GUIDE_JOY_R_CONTROLGUIDE	在暂停菜单中按[IMG_BUTTON_CLOVER_U]键\n可以确认按键配置。
SYS_POPUP_GUIDE_LARK3_CONTROLGUIDE	在暂停菜单中按[IMG_BUTTON_C_UP]键\n可以确认按键配置。
SYS_SORT_HEADING_PLAY_TIME	[VALUE]分钟
SYS_SORT_HEADING_DATE_PLAYED_1	[YEAR]/[MONTH]/[DAY]
SYS_SORT_HEADING_DATE_PLAYED_2	[MONTH]/[DAY]
SYS_USER_GUIDE_NUS_C_UP	[IMG_BUTTON_YELLOW_C_UP]
SYS_USER_GUIDE_NUS_C_DOWN	[IMG_BUTTON_YELLOW_C_DOWN]
SYS_USER_GUIDE_NUS_C_RIGHT	[IMG_BUTTON_YELLOW_C_RIGHT]
SYS_USER_GUIDE_NUS_C_LEFT	[IMG_BUTTON_YELLOW_C_LEFT]
SYS_USER_GUIDE_NUS_A	[IMG_BUTTON_BLUE_A]
SYS_USER_GUIDE_NUS_B	[IMG_BUTTON_GREEN_B]
SYS_USER_GUIDE_JOY_L_COMBINATION	[IMG_BUTTON_MINUS] + [IMG_BUTTON_SL] SELECT    [IMG_BUTTON_MINUS] + [IMG_BUTTON_SR] START
SYS_USER_GUIDE_JOY_R_COMBINATION	[IMG_BUTTON_PLUS] + [IMG_BUTTON_SL] SELECT    [IMG_BUTTON_PLUS] + [IMG_BUTTON_SR] START
SYS_USER_GUIDE_NUS_COMBINATION	[IMG_BUTTON_MINUS] + [IMG_BUTTON_STICK_L]：
SYS_USER_GUIDE_NUS_COMBINATION_01	[IMG_BUTTON_PLUS] + [IMG_BUTTON_STICK_R]：
SYS_USER_GUIDE_NUS_COMBINATION_02	[IMG_BUTTON_PLUS] + [IMG_BUTTON_RT]：START
SYS_USER_GUIDE_NUS_COMBINATION_03	[IMG_BUTTON_MINUS] + [IMG_BUTTON_LT]：START
SYS_USER_GUIDE_NUS_COMBINATION_04	[IMG_BUTTON_ZR] + [IMG_GAMEPAD_STICK_R]
SYS_USER_GUIDE_NUS_COMBINATION_05	[IMG_BUTTON_ZR] + [IMG_BUTTON_CLOVER_FULL_CORNER]：
SYS_USER_GUIDE_NUS_COMBINATION_06	[IMG_BUTTON_MINUS] + [IMG_BUTTON_CLOVER_FULL]：
SYS_USER_GUIDE_NUS_COMBINATION_07	[IMG_BUTTON_PLUS] + [IMG_BUTTON_CLOVER_FULL]：
SYS_USER_GUIDE_NUS_COMBINATION_08	[IMG_BUTTON_ZL]：Z扳机
SYS_USER_GUIDE_NUS_COMBINATION_09	[IMG_BUTTON_ZR]：Z扳机
SYS_USER_GUIDE_LARK_COMBINATION	[IMG_BUTTON_LARK_LT] + [IMG_BUTTON_LARK_RT] 暂停菜单
SYS_USER_GUIDE_LUCIA_COMBINATION	[IMG_BUTTON_LUCIA_ZL] + [IMG_BUTTON_LUCIA_ZR] 暂停菜单
SYS_USER_GUIDE_LARK3_PAUSE_MENU	[IMG_BUTTON_LUCIA_ZR]：暂停菜单
SYS_USER_GUIDE_SYSTEM_HOME	[IMG_BUTTON_HOME] HOME菜单
SYS_USER_GUIDE_LARK3_SYSTEM_HOME	[IMG_BUTTON_HOME]：HOME菜单
SYS_USER_GUIDE_SYSTEM_CAPTURE	[IMG_BUTTON_CAPTURE] 截图
SYS_USER_GUIDE_SYSTEM_CAPTURE2	截图 [IMG_BUTTON_CAPTURE]
SYS_USER_GUIDE_LARK3_SYSTEM_CAPTURE	[IMG_BUTTON_CAPTURE]：截图
titles
N-4868_j	バンジョーとカズーイの大冒険
N-3668_j	カスタムロボV2
N-4093_j	カスタムロボ
N-2456_j	F-ZERO X
N-3052_j	星之卡比64
N-4371_j	马力欧高尔夫64
N-3013_j	马力欧卡丁车64
N-1053_j	马力欧派对2
N-4737_j	马力欧派对
N-3017_j	马力欧网球64
N-2992_j	マリオストーリー
N-3783_j	パイロットウイングス64
N-3240_j	宝可梦随乐拍
N-3029_j	罪と罰 地球の継承者
N-3030_j	星际火狐64
N-3031_j	超级马力欧64
N-4813_j	ウエーブレース64
N-3034_j	WIN BACK
N-3036_j	ヨッシーストーリー
N-1407_j	塞尔达传说 魔吉拉的面具
N-3038_j	塞尔达传说 时之笛
