外伝011.txt
MID_外伝011	$SbpBGM_EVT_KINDNESS|0|$t1$Wmクレア|3$w0|$Wmフェルナン|7$w0|$Wsクレア|$Wa$SvpV_SIDE011_00|フェルナン！\nお久しぶりですこと。$k\n$Wsフェルナン|$Wa$SvpV_SIDE011_01|$E驚,|クレア…………$k$p$SvpV_SIDE011_02|$E悲,|まさか、本当に\nお前まで騎士団に入るとはな。$k$p$SvpV_SIDE011_03|昔から思っていたが\nお前たちの父上はお前に甘すぎるぞ。$k\n$Wsクレア|$Wa$E驚,|$SvpV_SIDE011_04|まあ、なにか問題がありまして？$k$p$SvpV_SIDE011_05|$Eキメ,|槍の腕前も騎馬の技術も\nお墨付きをいただきましたのよ。$k$p$SvpV_SIDE011_06|$E通常,|だいたい、わたくしにこれらを\n教えてくださったのは$k$p$SvpV_SIDE011_07|他でもないあなたと\nお兄さまじゃありませんか。$k\n$Wsフェルナン|$Wa$SvpV_SIDE011_08|$E通常,|お前はなんでも\n俺たちの真似をしたがるだけで$k$p$SvpV_SIDE011_09|年頃になれば\nそのうち飽きると思ったんだ。$k$p$SvpV_SIDE011_10|$E悲,|それが、婿探しもせず\n騎士団入りとは……$k$p$SvpV_SIDE011_11|戦場でいい男でも探すつもりか？$k\n$Wsクレア|$Wa$SvpV_SIDE011_12|$E悲,|うーん……\nわたくし、野蛮な方は苦手ですわ。$k$p$SvpV_SIDE011_13|$E通常,|それに、お婿さん探しを\nあきらめたわけではありませんのよ。$k$p$SvpV_SIDE011_14|$E笑,|騎士団に入れば、\nお城に常駐できるじゃありませんか。$k$p$SvpV_SIDE011_15|これからは毎日のように\n舞踏会に参加できますのね！$k\n$Wsフェルナン|$Wa$SvpV_SIDE011_16|$E苦,|お前……\n騎士団をなんだと思ってるんだ。$k$p$SvpV_SIDE011_17|そう上手くいくものか。$k$p$SvpV_SIDE011_18|$E通常,|任務に遠征に訓練に、\nやることは山のようにあるんだぞ。$k\n$Wsクレア|$Wa$SvpV_SIDE011_19|$E悲,|ええー？！\nそんな……期待外れですわ。$k$p$SvpV_SIDE011_20|じゃあ、やっぱり戦場で探すしか\nありませんの？$k$p$SvpV_SIDE011_21|$E通常,|でも、考えてみたら騎士団も\n貴族の子息の集まりですものね。$k$p$SvpV_SIDE011_22|$Eキメ,|ねえ、フェルナン。$k$p$SvpV_SIDE011_23|誰かわたくしにふさわしい方に\n心当たりはなくって？$k\n$Wsフェルナン|$Wa$SvpV_SIDE011_24|$E驚,|ふさわしいって……\nクレアはどういう男がいいんだ？$k\n$Wsクレア|$Wa$SvpV_SIDE011_25|$E通常,|そうですわね……$k$p$SvpV_SIDE011_26|家柄はまあ、\nわが家と釣り合えば結構ですのよ。$k$p$SvpV_SIDE011_27|$Eキメ,|あとは、お兄さまくらい背が高くて\nお顔が整っていて$k$p$SvpV_SIDE011_28|教養があって、武芸にも秀でていて……$k$p$SvpV_SIDE011_29|$E笑,|詩や音楽にも造詣が深い人が\nよろしいわね。$k$p$SvpV_SIDE011_30|$E通常,|それから\n春用と夏用と秋用と冬用と$k$p$SvpV_SIDE011_31|四つくらいは別荘をお持ちだったら\n文句はいいませんわ。$k\n$Wsフェルナン|$Wa$SvpV_SIDE011_32|$E悲,|はあ……\nよくわかったよ。$k$p$SvpV_SIDE011_33|$E特殊1,|お前はまだ婿を探すほど\n大人ではないということだな。$k\n$Wsクレア|$Wa$SvpV_SIDE011_34|$E怒,照|まあ！\nわたくしが子供だとおっしゃるの？$k\n$Wsフェルナン|$Wa$SvpV_SIDE011_35|$Eキメ,|ああ、そういっている。$k$p$SvpV_SIDE011_36|$E特殊1,|だいたい、お前のその理想の男は\nただのクレーベじゃないか。$k$p$SvpV_SIDE011_37|いいかげん兄離れしたらどうだ？$k\n$Wsクレア|$Wa$SvpV_SIDE011_38|$E苦,|ふんだ。その言葉、\nそっくりそのままお返ししましてよ。$k$p$SvpV_SIDE011_39|$E怒,|フェルナンこそ、\nわたくしが生まれる前から$k$p$SvpV_SIDE011_40|お兄さまにべったりじゃ\nありませんか。$k$p$SvpV_SIDE011_41|$E通常,|ご自分はどうですのよ。\n心に決めたお相手でもいらっしゃるの？$k\n$Wsフェルナン|$Wa$SvpV_SIDE011_42|$E驚,汗|……お、俺のことはいいだろう。$k\n$Wsクレア|$Wa$SvpV_SIDE011_43|$Eキメ,|あら？\n動揺しましたわね。$k$p$SvpV_SIDE011_44|ふふん、わたくし知っておりますのよ。\nお兄さまに聞きましたの。$k$p$SvpV_SIDE011_45|$E通常,|フェルナンは\n年上に弱いんですのよね。$k$p$SvpV_SIDE011_46|えーと、騎士団で\nフェルナンより年上の女性は……$k\n$Wsフェルナン|$Wa$SvpV_SIDE011_47|$E苦,汗|クレーベめ、余計なことを……！$k$p$SvpV_SIDE011_48|$E怒,|ああもう、この話はお終いだ。\n行くぞ！！$k\n$Wsフェルナン|$Wd$w0|$SspSE_EVT_3_HUMAN_WALK2_CORRIDOR|$w3000|$Wsクレア|$Wa$SvpV_SIDE011_49|$E怒,|まあ、逃げるなんて卑怯ですことよ。\nお待ちになって……！$k\n$Sbs1500|
外伝012.txt
MID_外伝012	$SbpBGM_EVT_DAILY|0|$t1$Wm若マチルダ|3$w0|$Wm若クレーベ|7$w0|$Ws若マチルダ|$Wa$SvpV_SIDE012_00|$E通常,|どうだ、クレーベ。\n騎士団にはもう慣れたかい？$k\n$Ws若クレーベ|$Wa$SvpV_SIDE012_01|$E通常,|マチルダ！\nああ、みんなよくしてくれているよ。$k$p$SvpV_SIDE012_02|$E悲,|でも、もう三か月も訓練ばかりで……\n早く戦場に出たくてたまらないんだ。$k\n$Ws若マチルダ|$Wa$SvpV_SIDE012_03|$E笑,|なに、焦ることはない。\n今のうちにしっかり腕を磨いておくといい。$k\n$Ws若クレーベ|$Wa$SvpV_SIDE012_04|$E悲,|でも、それではいつまでたっても\nマチルダに追いつけないじゃないか。$k\n$Ws若マチルダ|$Wa$SvpV_SIDE012_05|$E驚,|私に？$k\n$Ws若クレーベ|$Wa$SvpV_SIDE012_06|$E通常,|ああ。$k$p$SvpV_SIDE012_07|女性でありながら、\n騎士団一と謳われる女騎士マチルダ……$k$p$SvpV_SIDE012_08|$E笑,|国中の少年たちが\nどれだけその名前に胸を躍らせているか。$k$p$SvpV_SIDE012_09|あなたにはきっとわからないだろうな。$k$p$SvpV_SIDE012_10|$E通常,|私と幼なじみも、\nあなたの話ばかりしていたよ。$k\n$Ws若マチルダ|$Wa$SvpV_SIDE012_11|$E通常,|そうなのか。\nそれは意外だな。$k$p$SvpV_SIDE012_12|男の子が憧れるのは、\nあの英雄マイセン卿かと思っていたよ。$k\n$Ws若クレーベ|$Wa$SvpV_SIDE012_13|たしかにマイセン卿は尊敬すべきお方だ。$k$p$SvpV_SIDE012_14|私も彼のようになりたいと思っているよ。$k$p$SvpV_SIDE012_15|$E笑,|でも、年ごろの少年が\n威風堂々たる老騎士と美しい女騎士……$k$p$SvpV_SIDE012_16|どちらにより惹かれるかは\n火を見るより明らかだろう？$k\n$Ws若マチルダ|$Wa$SvpV_SIDE012_17|$E笑,|ふふふ……\n実物を見てがっかりされなければいいが。$k\n$Ws若クレーベ|$Wa$SvpV_SIDE012_18|$E驚,|とんでもない！$k$p$SvpV_SIDE012_19|$E通常,|戦場を駆けるあなたは、着飾って\n宮廷で取り澄ましているときより$k$p$SvpV_SIDE012_20|遥かに美しいよ。$k\n$Ws若マチルダ|$Wa$SvpV_SIDE012_21|$E怒,|取り澄ましているとはご挨拶だな。$k$p$SvpV_SIDE012_22|$E悲,|まあ、ああいう場が\n好きではないのは本当だが。$k$p$SvpV_SIDE012_23|$E通常,|そういえば、\nあの子犬のような妹君は元気か？$k$p$SvpV_SIDE012_24|私が君と話していると\nいつも間に入ってきていたな。$k\n$Ws若クレーベ|$Wa$SvpV_SIDE012_25|$E苦,|ああ……\n元気すぎて困るほどさ。$k$p$SvpV_SIDE012_26|私が騎士団に入るといったら\n泣きわめいて大変だったよ。$k\n$Ws若マチルダ|$Wa$SvpV_SIDE012_27|$E笑,|よほど君を好いているんだな。\n可愛いじゃないか。$k$p$SvpV_SIDE012_28|$E通常,|でも、ようやくこうして\n君とゆっくり話すことができて$k$p$SvpV_SIDE012_29|私もうれしいよ。$k\n$Ws若クレーベ|$Wa$SvpV_SIDE012_30|$E笑,|マチルダ……\nああ、私もだ。$k$p$SvpV_SIDE012_31|$E通常,|どうやら私たちには、\n華やかな宮廷より$k$p$SvpV_SIDE012_32|土埃の舞う戦場のほうが、よほど\n社交の場にはふさわしいみたいだな。$k\n$Ws若マチルダ|$Wa$SvpV_SIDE012_33|$E笑,|まったくだ。\nふふ……$k$p$SvpV_SIDE012_34|これでは、次にドレスに袖を通すのは\nいつになることやら。$k\n$Ws若クレーベ|$Wa$SvpV_SIDE012_35|$E驚,|……………………$k\n$Ws若マチルダ|$Wa$SvpV_SIDE012_36|$E通常,|クレーベ？$k\n$Ws若クレーベ|$Wa$SvpV_SIDE012_37|$E通常,|いや……$k$p$SvpV_SIDE012_38|では、そのときにはぜひ\n私と踊ってくれないか？$k\n$Ws若マチルダ|$Wa$SvpV_SIDE012_39|$E驚,|えっ……$k$p$SvpV_SIDE012_40|$E通常,|でも、本当にいつになるか\nわからないぞ？$k\n$Ws若クレーベ|$Wa$SvpV_SIDE012_41|$E通常,|待つさ、いつまでだって。\nあなたと踊れるのなら。$k\n$Ws若マチルダ|$Wa$SvpV_SIDE012_42|……そ、そうか。$k$p$SvpV_SIDE012_43|$E笑,|では……うん。\n約束しよう。$k\n$Ws若クレーベ|$Wa$SvpV_SIDE012_44|$E笑,|……ありがとう、マチルダ！$k$p$SvpV_SIDE012_45|じゃあ、その日を楽しみに。$k\n$Ws若クレーベ|$Wd$w0|$SspSE_EVT_5_HUMAN_RUN1_CORRIDOR|$w2000|$Ws若マチルダ|$Wa$E驚,|$SvpV_SIDE012_46|あ……行ってしまった。$k$p$E通常,|$SvpV_SIDE012_47|なにも走ることはないだろうに。\nふふ……$k$p$E苦,汗|$SvpV_SIDE012_48|……いや、笑いごとではないな。\nステップの練習をしておかねば。$k$p$SvpV_SIDE012_49|ああ、しまった。\nダンスなど忘却の彼方だぞ……！$k\n$Sbs1500|
MPID_若クレーベ	クレーベ
MPID_若マチルダ	マチルダ
外伝013.txt
MID_外伝013	$t1$Wmマチルダ|7$w0|$Wsマチルダ|$Wa$SvpV_SIDE013_00|$E通常,|ああ、いた。\nフェルナン！$k\n$Wmフェルナン|3$w0|$Wsフェルナン|$Wa$SvpV_SIDE013_01|$E特殊1,|マチルダ……\n俺になにか用か？$k\n$Wsマチルダ|$Wa$SvpV_SIDE013_02|ああ。\n今日はクレーベはどうしたんだ？$k\n$Wsフェルナン|$Wa$SvpV_SIDE013_03|$E通常,|……そういつもいっしょにいるものか。\n子供じゃあるまいし。$k\n$Wsマチルダ|$Wa$SvpV_SIDE013_04|$E驚,|それもそうだな。$k$p$SvpV_SIDE013_05|$E通常,|お前とクレーベは兄弟のようだから\nすぐふたりでひとつに考えてしまう。$k$p$SvpV_SIDE013_06|気を悪くしたのなら許してくれ。$k\n$Wsフェルナン|$Wa$SvpV_SIDE013_07|$E悲,|別に、悪くしたわけでは……$k\n$Wsマチルダ|$Wa$SvpV_SIDE013_08|$E特殊1,|そうなのか？$k$p$SvpV_SIDE013_09|お前は私と話すとき\nあまり目を合わせてくれないだろう。$k$p$SvpV_SIDE013_10|なにか嫌われるようなことを\nしてしまっただろうか。$k\n$Wsフェルナン|$Wa$SvpV_SIDE013_11|$E驚,汗|そ、そんなことはない！\n嫌ってなんか……$k$p$SvpV_SIDE013_12|$E悲,|ただ、お前がいつも\nクレーベのことばかり聞くから……$k\n$Wsマチルダ|$Wa$SvpV_SIDE013_13|$E驚,照|あ…………$k$p$SvpV_SIDE013_14|そ、そうだな。\nそれはお前に失礼だったな。$k$p$SvpV_SIDE013_15|$E通常,|すまない、つい……\nお前の話が楽しくて。$k\n$Wsフェルナン|$Wa$SvpV_SIDE013_16|$E通常,|俺の話……？$k$p$SvpV_SIDE013_17|クレーベから聞くのと\nたいして違わないだろう。$k\n$Wsマチルダ|$Wa$SvpV_SIDE013_18|違うさ。\nもちろん彼と話すのも楽しいが……$k$p$SvpV_SIDE013_19|$E笑,|クレーベはああ見えて\n少し見栄っ張りだからな。$k$p$SvpV_SIDE013_20|$E通常,|あまり自分の失敗を\n語ろうとはしないんだ。$k\n$Wsフェルナン|$Wa$SvpV_SIDE013_21|$E特殊1,|へえ？$k$p$SbpBGM_EVT_LOVE_BC|0|$SvpV_SIDE013_22|じゃあ、昼食会の前に\nこっそり食堂に忍び込んで$k$p$SvpV_SIDE013_23|ケーキのクリームだけ\n全部舐めてしまったことも？$k$p$SvpV_SIDE013_24|牧場の羊に乗ろうとしたら\n怯えたやつらが大暴れして$k$p$SvpV_SIDE013_25|壊れた柵から村中に逃げ出して\n大目玉をくらったこともか？$k\n$Wsマチルダ|$Wa$SvpV_SIDE013_26|$E笑,|あはは……\nそうそう、そういう話だ。$k\n$Wsフェルナン|$Wa$E特殊1,|$SvpV_SIDE013_27|いまでこそああして\n澄ましているが……$k$p$SvpV_SIDE013_28|クレーベのやつ、いざとなったら\n俺よりたちが悪いからな。$k$p$SvpV_SIDE013_29|$Eキメ,|マチルダも気をつけろよ。$k\n$Wsマチルダ|$Wa$E通常,|$SvpV_SIDE013_30|ああ、肝に銘じるよ。$k$p$SvpV_SIDE013_31|やはりいいな、お前の話は。\n……なあ、フェルナン。$k\n$Wsフェルナン|$Wa$SvpV_SIDE013_32|$E特殊1,|なんだ？$k\n$Wsマチルダ|$Wa$SvpV_SIDE013_33|私がお前から話を聞きたいのは\nもちろんそういうこともあるが……$k$p$SvpV_SIDE013_34|話しているお前を見るのも\n好きなんだ。$k\n$Wsフェルナン|$Wa$SvpV_SIDE013_35|$E驚,|えっ？$k\n$Wsマチルダ|$Wa$SvpV_SIDE013_36|本当に楽しそうで、愛おしそうで……$k$p$SvpV_SIDE013_37|お前たちがどれだけ幸福であったのか\n伝わってくるよ。$k$p$SvpV_SIDE013_38|$E笑,|なんだか嫉妬してしまうな。$k\n$Wsフェルナン|$Wa$SvpV_SIDE013_39|$E悲,|マチルダ……$k\n$Wsマチルダ|$Wa$SvpV_SIDE013_40|$E通常,|お前とクレーベが羊を逃がした牧場や\n宝物をかくした森を$k$p$SvpV_SIDE013_41|いつか私も見てみたいものだ。$k\n$Wsフェルナン|$Wa$SvpV_SIDE013_42|$E特殊1,|……いつかとは言わず\nいつでも来るといい。$k$p$SvpV_SIDE013_43|案内するよ。\n俺とクレーベとふたりで。$k\n$Wsマチルダ|$Wa$SvpV_SIDE013_44|フェルナン……\nありがとう。$k\n$Wsフェルナン|$Wa$Eキメ,|$SvpV_SIDE013_45|もっとも、その前に\nクレアの許可が必要だが。$k$p$SvpV_SIDE013_46|あいつは手強いぞ？$k\n$Wsマチルダ|$Wa$SvpV_SIDE013_47|$E通常,|ああ、薄々聞いてはいるが……$k$p$SvpV_SIDE013_48|今度はクレアの好きなものの話でも\n聞かせてくれ。$k\n$Wsフェルナン|$Wa$E特殊1,|$SvpV_SIDE013_49|はは……\nああ、任せておけ。$k\n$Sbs1500|
常駐_OCアルム.txt
MJID_OCアルム	オーバーL
MJID_L_OCアルム	オーバーロード
MJID_H_OCアルム	覇道に目覚めた者のみが\n至ることのできる境地
常駐_OCゴールドナイト.txt
MJID_OCゴールドナイト	ゲイレルル
MJID_L_OCゴールドナイト	ゲイレルル
MJID_H_OCゴールドナイト	誇り高き騎士の道を\n極めた者のみが至る境地
常駐_OCセリカ.txt
MJID_OCセリカ	メイヴ
MJID_L_OCセリカ	メイヴ
MJID_H_OCセリカ	王道に目覚めし乙女のみが\n至ることのできる境地
常駐_OCバロン.txt
MJID_OCバロン	スパルタン
MJID_L_OCバロン	スパルタン
MJID_H_OCバロン	重装騎士の道を極めし者\nのみが至る境地
MSID_完全防御	ファランクス
MSID_H_完全防御	守備／2の確率で攻撃を防ぐ\n隣接する味方の数で確率が倍加
常駐_OCファルコンナイト.txt
MJID_OCファルコンナイト	マッハ
MJID_L_OCファルコンナイト	マッハ
MJID_H_OCファルコンナイト	天駆ける騎士の道を極めし\n乙女のみが至る境地
常駐_OCボウナイト.txt
MJID_OCボウナイト	エレファント
MJID_L_OCボウナイト	エレファント
MJID_H_OCボウナイト	弓騎兵の道を極めし者\nのみが至る境地
MSID_弓射程＋３	弓射程＋３
MSID_H_弓射程＋３	弓の攻撃射程が\n３マス伸びる
常駐_OC神官.txt
MJID_OC神官	モルガーナ
MJID_L_OC神官	モルガーナ
MJID_H_OC神官	魔法剣士の道を極めし\n乙女のみが至る境地
常駐_OC聖女.txt
MJID_OC聖女	タイタニア
MJID_L_OC聖女	タイタニア
MJID_H_OC聖女	聖職者の道を極めし\n乙女のみが至る境地
MIID_Mシールド	Mシールド
MIID_H_Mシールド	１ターン　隣接する味方の\n魔法防御を上昇させる
MIID_レスト	レスト
MIID_H_レスト	範囲内にいる\n味方の状態異常を回復する
MSID_Mシールド	Mシールド
MSID_H_Mシールド	1ターン\n魔法防御が上昇する
常駐_OC賢者.txt
MJID_OC賢者	ソロモン
MJID_L_OC賢者	ソロモン
MJID_H_OC賢者	叡智の道を極めし者\nのみが至る境地
MIID_強化イリュージョン	レメゲトン
MIID_H_強化イリュージョン	幻影魔兵を召喚する\n（軍に８体まで）
常駐_OC魔戦士.txt
MJID_OC魔戦士	ヤシャ
MJID_L_OC魔戦士	ヤシャ
MJID_H_OC魔戦士	異形なる戦士の道を極めし\n者のみが至る境地
MSID_複数毒	刹鬼三毒
MSID_H_複数毒	攻撃命中時　技／2の確率で\n相手に状態異常を付与する
常駐_エマ.txt
MPID_エマ	エマ
MPID_H_エマ	一人前を目指す見習いの少女。
MIID_見習い天馬の槍	見習い天馬の槍
MIID_H_見習い天馬の槍	エマが昔から持っている槍
MSID_エマ戦技	１人Tアタック
MSID_H_エマ戦技	一人で三連続攻撃を行う
MID_DIE_エマ	$t1$Wmエマ|7$w0|$Wsエマ|$Wa$SvpV_DIE_EMMA_00|$E苦,汗|みんな……バイバイ……\n……大好きだった……よ……$k
MID_DIE_CASUAL_エマ	$t1$Wmエマ|7$w0|$Wsエマ|$Wa$SvpV_DIE_CASUAL_EMMA_00|$E苦,汗|うう……\nや、やられちゃいました……$k$p$SvpV_DIE_CASUAL_EMMA_01|……下がって見学させてもらいます！$k
MID_AFT_エマ	戦いが終わったあと、バレンシアを離れ\nまた新しい地へと旅立っていった。\nその後のことは記録に残っていないが\n噂ではペガサス、ファルコン、ドラゴン\nといった様々な動物を乗りこなし\n天空を翔ける騎士として、明るく元気に\n活躍をしていたという。
MID_LAST_エマ	$t1$Wmエマ|5$w0|$Wsエマ|$Wa$SvpV_SC_5_01_OP_EMMA_00|$E怒,|難しいことはよくわかりませんけど……$k$p$SvpV_SC_5_01_OP_EMMA_01|あたしたちは絶対にあなたには負けません！$k
MID_レベルアップ_エマ_身体	$SvpV_LU_EMMA_PHYSICAL_00|$E通常,|あたし、確実に強くなってます！
MID_レベルアップ_エマ_感覚	$SvpV_LU_EMMA_SENSE_00|$E通常,|今日のあたし、キレッキレです！
MID_レベルアップ_エマ_気分	$SvpV_LU_EMMA_FEEL_00|$E笑,|最近、運がいいなあって思ってました。
MID_レベルアップ_エマ_無し	$SvpV_LU_EMMA_NONE_00|$E悲,|こ……こんな日もありますよね？
MID_レベルアップ_エマ_限界	$SvpV_LU_EMMA_LIMIT_00|$Eキメ,|あたし……一人前になれたかな？
MID_クラスチェンジ_エマ	$SvpV_CC_EMMA_00|$E笑,|今まで以上に頑張ります！
常駐_クレアの槍.txt
MIID_クレアの槍	クレアの槍
MIID_H_クレアの槍	退魔の力と\n魔法への耐性を持つ槍
常駐_クレーベの槍.txt
MIID_クレーベの槍	クレーベの槍
MIID_H_クレーベの槍	道を拓く者の槍
MIID_ルカの盾	ルカの盾
MIID_H_ルカの盾	戦局を識る者の盾
常駐_パイソンの弓.txt
MIID_パイソンの弓	パイソンの弓
MIID_H_パイソンの弓	巧みな者の弓
常駐_フェルナンの槍.txt
MIID_フェルナンの槍	フェルナンの槍
MIID_H_フェルナンの槍	先駆者の槍
常駐_ランド.txt
MPID_ランド	ランド
MPID_H_ランド	飄々としたベテラン兵士。
MIID_気まぐれな槍	気まぐれな槍
MIID_H_気まぐれな槍	ランドが愛用している槍
MSID_ランド戦技	天国と地獄
MSID_H_ランド戦技	必殺または外れの攻撃を\n二連続で行う
MID_DIE_ランド	$t1$Wmランド|7$w0|$Wsランド|$Wa$SvpV_DIE_LANDO_00|$E苦,汗|あばよ……最期まで……\n楽し……かった……ぜ……$k
MID_DIE_CASUAL_ランド	$t1$Wmランド|7$w0|$Wsランド|$Wa$SvpV_DIE_CASUAL_LANDO_00|$E苦,汗|あいたたた……\nいいのを貰っちまったぜ……$k$p$SvpV_DIE_CASUAL_LANDO_01|悪いが、俺はここまでだ……\n引き上げさせてもらうぜ。$k
MID_AFT_ランド	戦いが終わったあと、バレンシアを離れ\nまた新しい地へと旅立っていった。\nその後のことは記録に残っていないが\n噂では二刀流の傭兵騎士として\n様々な武器を使いこなしながら\n数多の戦場で活躍をしていたという。
MID_LAST_ランド	$t1$Wmランド|5$w0|$Wsランド|$Wa$SvpV_SC_5_01_OP_LANDO_00|$E通常,|誰が世界を支配しようと、\n俺には関係ない話なんだが……$k$p$SvpV_SC_5_01_OP_LANDO_01|$Eキメ,|あんたらの下じゃあ楽しく無さそうだ。\nだから、邪魔させて貰うぜ。$k
MID_レベルアップ_ランド_身体	$SvpV_LU_LANDO_PHYSICAL_00|$E通常,|おっさんもなかなか強くなるだろう？
MID_レベルアップ_ランド_感覚	$SvpV_LU_LANDO_SENSE_00|$E通常,|色々なテクニックを身につけたいもんだ。
MID_レベルアップ_ランド_気分	$SvpV_LU_LANDO_FEEL_00|$Eキメ,|戦場で生き残るには、運がよくないとな。
MID_レベルアップ_ランド_無し	$SvpV_LU_LANDO_NONE_00|$Eキメ,汗|ははは……ま、こんなこともあるさ。
MID_レベルアップ_ランド_限界	$SvpV_LU_LANDO_LIMIT_00|$E通常,|調子にのって\n強くなりすぎちまったかな？
MID_クラスチェンジ_ランド	$SvpV_CC_LANDO_00|$Eキメ,|身が引き締まるねえ……！
常駐_外伝タイトル_G017.txt
MID_外伝タイトル_外伝011	どんなお方が
MID_外伝タイトル_外伝012	姫騎士と若騎士
常駐_外伝タイトル_G019.txt
MID_外伝タイトル_外伝013	幸福の記憶
常駐_星のオーブ.txt
MIID_星のアクエリアス	星のアクエリアス
MIID_星のピスケス	星のピスケス
MIID_星のアリエス	星のアリエス
MIID_星のタウルス	星のタウルス
MIID_星のジェミニ	星のジェミニ
MIID_星のキャンサー	星のキャンサー
MIID_星のレオ	星のレオ
MIID_星のバルゴ	星のバルゴ
MIID_星のリブラ	星のリブラ
MIID_星のスコーピオ	星のスコーピオ
MIID_星のサジタリス	星のサジタリス
MIID_星のカプコーン	星のカプコーン
MIID_星の宝珠	星の宝珠
MIID_H_星のアクエリアス	不思議な力を感じる\n青白い石の破片
MIID_H_星のピスケス	不思議な力を感じる\n青白い石の破片
MIID_H_星のアリエス	不思議な力を感じる\n青白い石の破片
MIID_H_星のタウルス	不思議な力を感じる\n青白い石の破片
MIID_H_星のジェミニ	不思議な力を感じる\n青白い石の破片
MIID_H_星のキャンサー	不思議な力を感じる\n青白い石の破片
MIID_H_星のレオ	不思議な力を感じる\n青白い石の破片
MIID_H_星のバルゴ	不思議な力を感じる\n青白い石の破片
MIID_H_星のリブラ	不思議な力を感じる\n青白い石の破片
MIID_H_星のスコーピオ	不思議な力を感じる\n青白い石の破片
MIID_H_星のサジタリス	不思議な力を感じる\n青白い石の破片
MIID_H_星のカプコーン	不思議な力を感じる\n青白い石の破片
MIID_H_星の宝珠	所有者を劇的に成長させる\n力を持つ神秘的な宝珠
拠点会話_エマ.txt
MID_拠点会話_エマ_1	$t1$Wmエマ|5$w0|$Wsエマ|$Wa$SvpV_BASE_EMMA_1_00|$E笑,|あらためまして、こんにちは！\nあたし、エマっていいます！$k$p$SvpV_BASE_EMMA_1_01|まだまだ見習いなので\n色々教えてくださいね。$k$p$SvpV_BASE_EMMA_1_02|$E通常,|この大陸には初めてきたんですけど\nいいところですね。$k$p$SvpV_BASE_EMMA_1_03|$E悲,|でも、いろいろ魔物が出没してて……\nちょっと怖いです。$k$p$SvpV_BASE_EMMA_1_04|$Eキメ,|ファルコンナイトは\n魔物に強いんですよね？$k$p$SvpV_BASE_EMMA_1_05|怖い魔物を、シャキーンって\n全滅させられるといいですね！$k$p$SvpV_BASE_EMMA_1_06|$E笑,|あたし、手伝っちゃいますから\nよろしくお願いします！$k
拠点会話_ランド.txt
MID_拠点会話_ランド_1	$t1$Wmランド|5$w0|$Wsランド|$Wa$SvpV_BASE_LANDO_1_00|$E笑,|俺はランドだ。\nって、自己紹介は済んでたっけな。$k$p$SvpV_BASE_LANDO_1_01|しばらく厄介になるぜ。\n仲良くしてやってくれ。$k$p$SvpV_BASE_LANDO_1_02|$Eキメ,|あちこち旅して来たんだが……\nここもなかなか面白い土地だな。$k$p$SvpV_BASE_LANDO_1_03|オレンジも美味いし、\n可愛い嬢ちゃんもいる。気に入ったぜ。$k$p$SvpV_BASE_LANDO_1_04|$E通常,|ところであんた……『無限の混沌』って\n言葉を聞いた事ないか？$k$p$SvpV_BASE_LANDO_1_05|$E笑,|いや、ないなら良いんだ。\nわすれてくれ。$k\n
支援会話_エマ_ランド.txt
MID_支援会話_エマ_ランド_C	$t1$Wmエマ|7$w0|$Wmランド|3$w0|$Wsエマ|$Wa$SvpV_RELIANCE_EMMA_LANDO_C_00|$E笑,|あ！　ランドさん！$k\n$Wsランド|$Wa$SvpV_RELIANCE_EMMA_LANDO_C_01|ようエマ。頑張ってるか？$k\n$Wsエマ|$Wa$SvpV_RELIANCE_EMMA_LANDO_C_02|$E通常,|ランドさんこそ。こっそりサボって\n例の遊びをしにいったりしてないですか？$k\n$Wsランド|$Wa$SvpV_RELIANCE_EMMA_LANDO_C_03|$E特殊1,|言っただろう。もうしないって\n俺が約束を破る男に見えるか？$k\n$Wsエマ|$Wa$SvpV_RELIANCE_EMMA_LANDO_C_04|$E怒,|ジー……！$k\n$Wsランド|$Wa$SvpV_RELIANCE_EMMA_LANDO_C_05|$E通常,汗|よ、よせよ。無言で見つめられると……\n照れるだろ。$k\n$Wsエマ|$Wa$SvpV_RELIANCE_EMMA_LANDO_C_06|$E笑,|あはは。本当に行ってないみたいですね！$k\n$Wsランド|$Wa$SvpV_RELIANCE_EMMA_LANDO_C_07|$Eキメ,|俺って意外と誠実な男だからな。$k$p$SvpV_RELIANCE_EMMA_LANDO_C_08|$E通常,|だが、お陰で楽しみが減っちまってな……\nちょっとばかり退屈してるんだ。$k$p$SvpV_RELIANCE_EMMA_LANDO_C_09|エマ、何か楽しい遊びをしらないか？$k\n$Wsエマ|$Wa$SvpV_RELIANCE_EMMA_LANDO_C_10|$E通常,|楽しい遊び……ですか？$k\n$Wsランド|$Wa$SvpV_RELIANCE_EMMA_LANDO_C_11|$Eキメ,|なんかあるだろう。\nほら、今ハマってることとか。$k\n$Wsエマ|$Wa$SvpV_RELIANCE_EMMA_LANDO_C_12|$E笑,|ああ、ハマってることといえば……\n「一人トライアングルアタック」です！$k\n$Wsランド|$Wa$SvpV_RELIANCE_EMMA_LANDO_C_13|$E苦,汗|一人……なんだって？$k\n$Wsエマ|$Wa$SvpV_RELIANCE_EMMA_LANDO_C_14|$Eキメ,|「一人トライアングルアタック」です！$k\n$Wsランド|$Wa$SvpV_RELIANCE_EMMA_LANDO_C_15|$E驚,|トライアングルアタックってお前……\nあれは三人とかでやるもんじゃないのか？$k\n$Wsエマ|$Wa$SvpV_RELIANCE_EMMA_LANDO_C_16|$E通常,|あたし、まだまだ半人前ですから\n人様の手を煩わせるなんて恐れ多くて！$k$p$SvpV_RELIANCE_EMMA_LANDO_C_17|だけど、憧れの技ですから\n最近一人で練習してるんです。$k\n$Wsランド|$Wa$SvpV_RELIANCE_EMMA_LANDO_C_18|$Eキメ,|おっと、用事を思い出した。\nじゃあな。$k\n$Wsエマ|$Wa$SvpV_RELIANCE_EMMA_LANDO_C_19|$E驚,|逃げないでー！！$k$p$SvpV_RELIANCE_EMMA_LANDO_C_20|$E怒,|ムム……もしかして、\nあの伝説の技をバカにしてますね？$k\n$Wsランド|$Wa$SvpV_RELIANCE_EMMA_LANDO_C_21|$E悲,|いや、そういうわけじゃ……$k\n$Wsエマ|$Wa$SvpV_RELIANCE_EMMA_LANDO_C_22|$E笑,|罰として、今度ランドさんも一緒に\n練習に付き合ってくださいね！$k\n$Wsランド|$Wa$SvpV_RELIANCE_EMMA_LANDO_C_23|$E驚,|え……なんで俺が？$k\n$Wsエマ|$Wa$SvpV_RELIANCE_EMMA_LANDO_C_24|$E笑,|絶対絶対……ぜーったい\n付き合ってくださいね！$k\n$Wsランド|$Wa$SvpV_RELIANCE_EMMA_LANDO_C_25|おお……わ、わかったよ。$k$p$SvpV_RELIANCE_EMMA_LANDO_C_26|$E苦,|（なんだか、\n面倒なことになっちまったな……）$k
MID_支援会話_エマ_ランド_B	$t1$Wmエマ|7$w0|$Wmランド|3$w0|$Wsエマ|$Wa$SvpV_RELIANCE_EMMA_LANDO_B_00|$E笑,|ランドさーん！$k\n$Wsランド|$Wa$E驚,汗|$SvpV_RELIANCE_EMMA_LANDO_B_01|げ！　エマ！$k\n$Wsエマ|$Wa$SvpV_RELIANCE_EMMA_LANDO_B_02|$E笑,|ちょうど良かった。\nまた例の練習、行きますよ！$k\n$Wsランド|$Wa$SvpV_RELIANCE_EMMA_LANDO_B_03|$E悲,|あ、ああ……わかったぜ。$k\n$Wsエマ|$Wa$SvpV_RELIANCE_EMMA_LANDO_B_04|$Eキメ,|せーの！　トライアングルアターック！$k\n$Wsランド|$Wa$SvpV_RELIANCE_EMMA_LANDO_B_05|$E通常,|と……とらいあんぐる……あたーっく。$k\n$Wsエマ|$Wa$SvpV_RELIANCE_EMMA_LANDO_B_06|$E怒,|声が小さい！\nトライアングルアターック！$k\n$Wsランド|$Wa$SvpV_RELIANCE_EMMA_LANDO_B_07|$Eキメ,|ちくしょう、ヤケだ……\nトライアングルアターック！！$k\n$Wsエマ|$Wa$SvpV_RELIANCE_EMMA_LANDO_B_08|$E笑,|うんうん。いい感じになってきましたね。$k$p$SvpV_RELIANCE_EMMA_LANDO_B_09|$Eキメ,|この掛け声とともに攻撃を３回\nすばやくくり出すのが基本です！$k\n$Wsランド|$Wa$SvpV_RELIANCE_EMMA_LANDO_B_10|$Eキメ,|お、おお、そうか。なるほどな……$k$p$SvpV_RELIANCE_EMMA_LANDO_B_11|$E悲,|（やれやれ、\nどうして俺がこんなことを……）$k\n$Wsエマ|$Wa$SvpV_RELIANCE_EMMA_LANDO_B_12|$E怒,|むむっ！\nまたそんな不満そうな顔して……$k$p$SvpV_RELIANCE_EMMA_LANDO_B_13|そんな事じゃ\n立派な天馬騎士になれませんよ！$k\n$Wsランド|$Wa$SvpV_RELIANCE_EMMA_LANDO_B_14|い、いや、別に目指してないんだが……$k$p$SvpV_RELIANCE_EMMA_LANDO_B_15|$E通常,|だいたい俺は男なんだから\nペガサス乗りにはなれんだろう。$k\n$Wsエマ|$Wa$SvpV_RELIANCE_EMMA_LANDO_B_16|$E驚,|え！？　そうなんですか？$k\n$Wsランド|$Wa$SvpV_RELIANCE_EMMA_LANDO_B_17|$E通常,|少なくともバレンシアやアカネイアには\nそういう奴はいないと思うぜ。$k\n$Wsエマ|$Wa$SvpV_RELIANCE_EMMA_LANDO_B_18|$E笑,汗|あれれ？　そうでしたっけ？$k$p$SvpV_RELIANCE_EMMA_LANDO_B_19|$E怒,|いやいや、あきらめちゃダメです！\n頑張ったらきっとなれますよ！$k\n$Wsランド|$Wa$SvpV_RELIANCE_EMMA_LANDO_B_20|$E悲,|いや、だから目指してないんだって。$k$p$SvpV_RELIANCE_EMMA_LANDO_B_21|そもそも、\n俺は空を飛んだことがないからな。$k$p$SvpV_RELIANCE_EMMA_LANDO_B_22|向いてる向いてない以前の問題だ。$k\n$Wsエマ|$Wa$SvpV_RELIANCE_EMMA_LANDO_B_23|$E通常,|なるほど。そこからですか。$k$p$SvpV_RELIANCE_EMMA_LANDO_B_24|$E笑,|じゃあ今度一緒に空を飛んでみますか？$k\n$Wsランド|$Wa$SvpV_RELIANCE_EMMA_LANDO_B_25|$E笑,|お、いいねえ。\nやっと楽しそうな話になってきたぞ。$k$p$SvpV_RELIANCE_EMMA_LANDO_B_26|空を自由に飛ぶってのは憧れだよな。\nどこでも連れてってくれるのか？$k\n$Wsエマ|$Wa$SvpV_RELIANCE_EMMA_LANDO_B_27|$E笑,|友達に乗せて貰えるように頼んでみます。\nあたしにまかせてください！$k\n$Wsランド|$Wa$SvpV_RELIANCE_EMMA_LANDO_B_28|じゃあ、約束だ。\n楽しみにしてるぞ、エマ。$k\n$Wsエマ|$Wa$SvpV_RELIANCE_EMMA_LANDO_B_29|$Eキメ,|はい！\n期待して待っていてください！$k
MID_支援会話_エマ_ランド_A	$t1$Wmエマ|7$w0|$Wmランド|3$w0|$Wsエマ|$Wa$SvpV_RELIANCE_EMMA_LANDO_A_00|$E悲,汗|ランドさん……\nあのあと、大丈夫でしたか？$k\n$Wsランド|$Wa$SvpV_RELIANCE_EMMA_LANDO_A_01|$E悲,|大丈夫だった……\nって言いたいところだが$k$p$SvpV_RELIANCE_EMMA_LANDO_A_02|正直、この前の空中デートは応えたぜ……$k$p$SvpV_RELIANCE_EMMA_LANDO_A_03|$E苦,|密集した森の木の間を飛んだり$k$p$SvpV_RELIANCE_EMMA_LANDO_A_04|入り組んだ狭い洞窟の中を\n潜り抜けたり……$k\n$Wsエマ|$Wa$SvpV_RELIANCE_EMMA_LANDO_A_05|$E笑,|ついでに吸血コウモリに追いかけられたり$k$p$SvpV_RELIANCE_EMMA_LANDO_A_06|鳥と間違えられて\n弓をいっぱい射られたり！$k\n$Wsランド|$Wa$SvpV_RELIANCE_EMMA_LANDO_A_07|$Eキメ,|おっさんにはスリル満点すぎた……$k$p$SvpV_RELIANCE_EMMA_LANDO_A_08|天馬騎士ってのは\nいつもあんなことしてるのか？$k\n$Wsエマ|$Wa$SvpV_RELIANCE_EMMA_LANDO_A_09|$E笑,|えへへ、まあ、そうですね。\n日常茶飯事だと思います。$k$p$SvpV_RELIANCE_EMMA_LANDO_A_10|$E悲,|でも、ランドさんは\nビックリしましたよね。$k$p$SvpV_RELIANCE_EMMA_LANDO_A_11|その……ごめんなさい。$k\n$Wsランド|$Wa$SvpV_RELIANCE_EMMA_LANDO_A_12|$E悲,|まあ、想像とは違う意味では……\n楽しかった。$k$p$SvpV_RELIANCE_EMMA_LANDO_A_13|だが、正直……しばらくは天馬に\n近づきたくもないかな。$k\n$Wsエマ|$Wa$SvpV_RELIANCE_EMMA_LANDO_A_14|$E通常,|色々あたしのわがままに付き合って\nもらっちゃって……すみませんでした。$k$p$SvpV_RELIANCE_EMMA_LANDO_A_15|代わりといってはなんですけど、$k$p$SvpV_RELIANCE_EMMA_LANDO_A_16|ランドさんは\nもう好きな事をして遊んでいいです。$k$p$SvpV_RELIANCE_EMMA_LANDO_A_17|新しい楽しい遊びを教えてあげられなくて\nゴメンなさい。$k\n$Wsランド|$Wa$SvpV_RELIANCE_EMMA_LANDO_A_18|$Eキメ,|いや、いいんだ。$k$p$SvpV_RELIANCE_EMMA_LANDO_A_19|それより、俺の気持ちが落ち着いたら\nまた天馬に乗せてくれ。$k\n$Wsエマ|$Wa$SvpV_RELIANCE_EMMA_LANDO_A_20|$E驚,|え！？$k\n$Wsランド|$Wa$SvpV_RELIANCE_EMMA_LANDO_A_21|$E笑,|俺もスリルのある遊びをいままで\n色々やってきたが……$k$p$SvpV_RELIANCE_EMMA_LANDO_A_22|あの天馬に乗っている時が一番だった。$k\n$Wsエマ|$Wa$SvpV_RELIANCE_EMMA_LANDO_A_23|$E通常,|そ、そうなんですか？$k\n$Wsランド|$Wa$Eキメ,|$SvpV_RELIANCE_EMMA_LANDO_A_24|ああ、あんな体験をした後じゃ\n何をやっても刺激が足りない……$k$p$SvpV_RELIANCE_EMMA_LANDO_A_25|$E笑,|嬢ちゃん。俺をこんな身体にした\n責任をとってくれよな。$k$p$SvpV_RELIANCE_EMMA_LANDO_A_26|$E笑,|また楽しくて刺激的な空の旅に\nちょくちょく連れて行ってやってくれ。$k\n$Wsエマ|$Wa$SvpV_RELIANCE_EMMA_LANDO_A_27|$E笑,|ええ！\nそんなことで良ければ……いくらでも！$k\n$Wsランド|$Wa$SvpV_RELIANCE_EMMA_LANDO_A_28|約束だぜ？\nじゃあ、またよろしく頼む！$k\n$Wsエマ|$Wa$SvpV_RELIANCE_EMMA_LANDO_A_29|$E笑,|はい！　ランドさん！$k
支援会話_クレア_マチルダ.txt
MID_支援会話_クレア_マチルダ_C	$t1$Wmクレア|7$w0|$Wmマチルダ|3$w0|$Wsクレア|$Wa$SvpV_RELIANCE_CLEA_MACHILDA_C_00|$E驚,|あ……\nマチルダさま。$k\n$Wsマチルダ|$Wa$SvpV_RELIANCE_CLEA_MACHILDA_C_01|$E通常,|やあ、クレア。\n君とこうして話すのも久しぶりだな。$k\n$Wsクレア|$Wa$SvpV_RELIANCE_CLEA_MACHILDA_C_02|$E通常,|ええ、本当に……$k$p$SvpV_RELIANCE_CLEA_MACHILDA_C_03|$E悲,|マチルダさまがドゼーに捕らわれたときは\nどうなることかと思いました。$k$p$SvpV_RELIANCE_CLEA_MACHILDA_C_04|$E通常,|ご無事でなによりでしたわ。$k\n$Wsマチルダ|$Wa$SvpV_RELIANCE_CLEA_MACHILDA_C_05|$E通常,|ありがとう。$k$p$SvpV_RELIANCE_CLEA_MACHILDA_C_06|ドゼーを討ち破ってくれた\nみんなのおかげだよ。$k\n$Wsクレア|$Wa$SvpV_RELIANCE_CLEA_MACHILDA_C_07|$E悲,|わたくしも、南の砦で\n敵に捕まったことがありますの。$k$p$SvpV_RELIANCE_CLEA_MACHILDA_C_08|とても不安で心細くて……\n夜も眠れませんでした。$k$p$SvpV_RELIANCE_CLEA_MACHILDA_C_09|マチルダさまは、わたくしよりも\nずっと長い間$k$p$SvpV_RELIANCE_CLEA_MACHILDA_C_10|あんな思いをされていましたのね……$k\n$Wsマチルダ|$Wa$SvpV_RELIANCE_CLEA_MACHILDA_C_11|$E驚,|クレア……$k$p$SvpV_RELIANCE_CLEA_MACHILDA_C_12|$E通常,|うれしいよ、そんなにも\n私を思いやってくれて。$k$p$SvpV_RELIANCE_CLEA_MACHILDA_C_13|$E笑,|でも私は、いつかきっと\nクレーベが助けてくれると信じていた。$k$p$SvpV_RELIANCE_CLEA_MACHILDA_C_14|$E通常,|心細いことはなかったよ。$k\n$Wsクレア|$Wa$SvpV_RELIANCE_CLEA_MACHILDA_C_15|$E通常,|……そうですか。\nマチルダさまはお強いんですのね。$k$p$SvpV_RELIANCE_CLEA_MACHILDA_C_16|わたくしも\n見習わなければなりませんわ。$k\n$Wsマチルダ|$Wa$SvpV_RELIANCE_CLEA_MACHILDA_C_17|$E驚,|クレア……$k
MID_支援会話_クレア_マチルダ_B	$t1$Wmクレア|7$w0|$Wmマチルダ|3$w0|$Wsマチルダ|$Wa$SvpV_RELIANCE_CLEA_MACHILDA_B_00|………………$k\n$Wsクレア|$Wa$SvpV_RELIANCE_CLEA_MACHILDA_B_01|$E驚,|……なんですの？\nマチルダさま。$k$p$SvpV_RELIANCE_CLEA_MACHILDA_B_02|わたくしの顔をじっと見つめて……$k$p$SvpV_RELIANCE_CLEA_MACHILDA_B_03|$E怒,|ご用があるなら\n遠慮せずにおっしゃってくださいな。$k\n$Wsマチルダ|$Wa$SvpV_RELIANCE_CLEA_MACHILDA_B_04|$E驚,|ああ、すまない。\n用というわけでもないんだが……$k$p$SvpV_RELIANCE_CLEA_MACHILDA_B_05|$E通常,|しばらく見ないうちに、君が\n少し変わったように思ってな。$k\n$Wsクレア|$Wa$SvpV_RELIANCE_CLEA_MACHILDA_B_06|$E驚,|わたくしが？\nどうしてそう思われますの？$k\n$Wsマチルダ|$Wa$SvpV_RELIANCE_CLEA_MACHILDA_B_07|$E通常,|この間、\n私をいたわってくれただろう？$k$p$SvpV_RELIANCE_CLEA_MACHILDA_B_08|$E笑,|それに、以前よりもずっと\n周囲を見て$k$p$SvpV_RELIANCE_CLEA_MACHILDA_B_09|自分にできることはないか\n見極めようとしている。$k$p$SvpV_RELIANCE_CLEA_MACHILDA_B_10|$E通常,|とても立派だよ、クレア。\n随分大人になったんだな。$k\n$Wsクレア|$Wa$E驚,|$SvpV_RELIANCE_CLEA_MACHILDA_B_11|マチルダさま……$k$p$SvpV_RELIANCE_CLEA_MACHILDA_B_12|$E悲,|そ、そうかしら。\nわたくし、別に変わりませんことよ。$k\n$Wsマチルダ|$Wa$SvpV_RELIANCE_CLEA_MACHILDA_B_13|ほら、やっぱり。$k\n$Wsクレア|$Wa$SvpV_RELIANCE_CLEA_MACHILDA_B_14|$E驚,|え？$k\n$Wsマチルダ|$Wa$SvpV_RELIANCE_CLEA_MACHILDA_B_15|$E笑,|以前だったら、\nわたくしが子供だとおっしゃるの？$k$p$SvpV_RELIANCE_CLEA_MACHILDA_B_16|$E通常,|……なんて、\n噛みつかれていたところだよ。$k\n$Wsクレア|$Wa$SvpV_RELIANCE_CLEA_MACHILDA_B_17|$E怒,|まあ！\nそんなことありませんわ。$k$p$SvpV_RELIANCE_CLEA_MACHILDA_B_18|$E悲,|……いえ、多少はあったかも\nしれませんけど…………$k\n$Wsマチルダ|$Wa$SvpV_RELIANCE_CLEA_MACHILDA_B_19|$E笑,|ふふふ……$k
MID_支援会話_クレア_マチルダ_A	$t1$Wmクレア|7$w0|$Wmマチルダ|3$w0|$Wsクレア|$Wa$SvpV_RELIANCE_CLEA_MACHILDA_A_00|$E通常,|マチルダさま。$k\n$Wsマチルダ|$Wa$SvpV_RELIANCE_CLEA_MACHILDA_A_01|$E通常,|やあ、クレア。\nどうしたんだ？$k$p$SvpV_RELIANCE_CLEA_MACHILDA_A_02|君から声をかけてくるなんて\n珍しいじゃないか。$k\n$Wsクレア|$Wa$SvpV_RELIANCE_CLEA_MACHILDA_A_03|$E悲,|……この間のお話ですけど、\nやっぱり少し違う気がしますの。$k\n$Wsマチルダ|$Wa$SvpV_RELIANCE_CLEA_MACHILDA_A_04|$E驚,|違う？$k\n$Wsクレア|$Wa$SvpV_RELIANCE_CLEA_MACHILDA_A_05|$E悲,|わたくし、大人になろうとして\nなったのではなくて……$k$p$SvpV_RELIANCE_CLEA_MACHILDA_A_06|なってしまったのですわ。\nきっと。$k$p$SvpV_RELIANCE_CLEA_MACHILDA_A_07|$E通常,|昔は、騎士団で毎日\nお兄さまとフェルナンといっしょで$k$p$SvpV_RELIANCE_CLEA_MACHILDA_A_08|大変なこともありましたけど、\nとても楽しかった……$k$p$SvpV_RELIANCE_CLEA_MACHILDA_A_09|$E笑,|わたくし、望めば叶わないことなんて\nないと思ってましたわ。$k$p$SvpV_RELIANCE_CLEA_MACHILDA_A_10|$E悲,|でも、いまはもう\nそうではないことを知っています。$k$p$SvpV_RELIANCE_CLEA_MACHILDA_A_11|思い通りにならないことばかりで\nどうしたらいいかわからなくて……$k$p$SvpV_RELIANCE_CLEA_MACHILDA_A_12|それで、人の顔色ばかり\n見るようになったのですわ。$k\n$Wsマチルダ|$Wa$SvpV_RELIANCE_CLEA_MACHILDA_A_13|$E特殊1,|クレア……$k\n$Wsクレア|$Wa$SvpV_RELIANCE_CLEA_MACHILDA_A_14|$E悲,|マチルダさまのおっしゃるような、\nそんないいものではありません。$k$p$SvpV_RELIANCE_CLEA_MACHILDA_A_15|わたくし、こんな自分が\nちょっぴり嫌いですもの。$k\n$Wsマチルダ|$Wa$SvpV_RELIANCE_CLEA_MACHILDA_A_16|$E怒,|それは違う、クレア。$k$p$SvpV_RELIANCE_CLEA_MACHILDA_A_17|$E通常,|いまの君は以前よりずっと素敵だ。\nなにも恥じることはない。$k\n$Wsクレア|$Wa$SvpV_RELIANCE_CLEA_MACHILDA_A_18|$E驚,|マチルダさま……$k\n$Wsマチルダ|$Wa$SvpV_RELIANCE_CLEA_MACHILDA_A_19|$E通常,|それに、望みが叶わないなんて\n誰が決めたんだ？$k$p$SvpV_RELIANCE_CLEA_MACHILDA_A_20|たしかに、なにもかも\n思い通りにはならないけれど……$k$p$SvpV_RELIANCE_CLEA_MACHILDA_A_21|$E笑,|望んでいたのとは違う形で\n叶ったりもするものだ。$k$p$SvpV_RELIANCE_CLEA_MACHILDA_A_22|$E通常,|あきらめてしまうのは\nまだ早いんじゃないか？$k\n$Wsクレア|$Wa$SvpV_RELIANCE_CLEA_MACHILDA_A_23|$E通常,|……ありがとうございます。\nそうですわね。$k$p$SvpV_RELIANCE_CLEA_MACHILDA_A_24|わたくし、\nちょっと弱気になっていましたわ。$k$p$SvpV_RELIANCE_CLEA_MACHILDA_A_25|$E笑,|これでは、お兄さまに\n笑われてしまいます。$k\n$Wsマチルダ|$Wa$SvpV_RELIANCE_CLEA_MACHILDA_A_26|$E通常,|そうとも。\n大丈夫、君は必ず幸せになれる。$k$p$SvpV_RELIANCE_CLEA_MACHILDA_A_27|いや、私とクレーベが\nきっとしてみせるさ。$k\n$Wsクレア|$Wa$SvpV_RELIANCE_CLEA_MACHILDA_A_28|$E驚,|マチルダさま……$k\n$Wsマチルダ|$Wa$SvpV_RELIANCE_CLEA_MACHILDA_A_29|$E苦,|だから、その……$k$p$SvpV_RELIANCE_CLEA_MACHILDA_A_30|$E通常,|これからは、もう少し\n仲良くしてくれると嬉しいな。$k\n$Wsクレア|$Wa$SvpV_RELIANCE_CLEA_MACHILDA_A_31|$E怒,照|そ、それは…………\n考えておきますわ。$k\n$Wsマチルダ|$Wa$SvpV_RELIANCE_CLEA_MACHILDA_A_32|$E笑,|ふふっ……\nああ、よろしく頼む。$k
支援会話_クレーベ_パイソン.txt
MID_支援会話_クレーベ_パイソン_C	$t1$Wmパイソン|7$w0|$Wsパイソン|$Wa$SvpV_RELIANCE_CLERBE_PAISON_C_00|$E悲,|あー、しんどい……\nまだ終わんないの？$k$p$SvpV_RELIANCE_CLERBE_PAISON_C_01|$E通常,|今日はあんまり前に出るの\nやめとこっかな……$k\n$Wmクレーベ|3$w0|$Wsクレーベ|$Wa$SvpV_RELIANCE_CLERBE_PAISON_C_02|$E通常,|パイソン。$k\n$Wsパイソン|$Wa$SvpV_RELIANCE_CLERBE_PAISON_C_03|$E驚,|ぎゃっ！$k\n$Wsクレーベ|$Wa$SvpV_RELIANCE_CLERBE_PAISON_C_04|そんなに驚くことはないだろう。\nどうだ、調子は。$k\n$Wsパイソン|$Wa$SvpV_RELIANCE_CLERBE_PAISON_C_05|$E通常,|はあ、まあ……\n普通です。$k\n$Wsクレーベ|$Wa$SvpV_RELIANCE_CLERBE_PAISON_C_06|$E通常,|……正直だな。\nそれがお前のいいところではあるが……$k$p$SvpV_RELIANCE_CLERBE_PAISON_C_07|解放軍もアルムをリーダーにむかえ\n若い兵が増えてきた。$k$p$SvpV_RELIANCE_CLERBE_PAISON_C_08|みな経験も浅く、\n不安に思うことも多いだろう。$k$p$SvpV_RELIANCE_CLERBE_PAISON_C_09|$E笑,|お前も先輩として\n手本を示してやってくれないか。$k\n$Wsパイソン|$Wa$SvpV_RELIANCE_CLERBE_PAISON_C_10|$Eキメ,|そーんなの、俺じゃなくったって$k$p$SvpV_RELIANCE_CLERBE_PAISON_C_11|クレーベさまやルカやフォルスが\nいるじゃありませんか。$k$p$SvpV_RELIANCE_CLERBE_PAISON_C_12|$E通常,|俺までそんな、\nお堅く真面目に振るまったら$k$p$SvpV_RELIANCE_CLERBE_PAISON_C_13|新しく入った連中が\n息詰まっちゃいますよ。$k\n$Wsクレーベ|$Wa$SvpV_RELIANCE_CLERBE_PAISON_C_14|$E驚,|だが、集団には規律というものが\n必要だろう。$k\n$Wsパイソン|$Wa$SvpV_RELIANCE_CLERBE_PAISON_C_15|$E通常,|それとは別に\n雰囲気ってもんもありますよ。$k\n$Wsクレーベ|$Wa$SvpV_RELIANCE_CLERBE_PAISON_C_16|$E悲,|……わが解放軍のそれは好ましくないと？$k\n$Wsパイソン|$Wa$SvpV_RELIANCE_CLERBE_PAISON_C_17|$E悲,|いや、\nそこまでは言いませんけど……$k$p$SvpV_RELIANCE_CLERBE_PAISON_C_18|$E通常,|たまに居心地の悪さは感じますね。$k\n$Wsクレーベ|$Wa$SvpV_RELIANCE_CLERBE_PAISON_C_19|$E悲,|……そうか……$k
MID_支援会話_クレーベ_パイソン_B	$t1$Wmパイソン|7$w0|$Wmクレーベ|3$w0|$Wsクレーベ|$Wa$SvpV_RELIANCE_CLERBE_PAISON_B_00|$E通常,|ああ、パイソン。\nちょうどよかった。$k\n$Wsパイソン|$Wa$SvpV_RELIANCE_CLERBE_PAISON_B_01|$E通常,|はあ、なんでしょう。$k\n$Wsクレーベ|$Wa$SvpV_RELIANCE_CLERBE_PAISON_B_02|先日話したことなんだが……\nどうも気になってしまってな。$k$p$SvpV_RELIANCE_CLERBE_PAISON_B_03|$E悲,|騎士団や貴族出身の者たちと\nお前たち平民の者との間に$k$p$SvpV_RELIANCE_CLERBE_PAISON_B_04|埋めがたい溝があることは\n私もわかっている。$k$p$SvpV_RELIANCE_CLERBE_PAISON_B_05|$E通常,|だからこそ、\n出自によらず働きのみを見ようと$k$p$SvpV_RELIANCE_CLERBE_PAISON_B_06|心がけてきたつもりなのだが……$k$p$SvpV_RELIANCE_CLERBE_PAISON_B_07|$E悲,|お前にとっては\nそうではなかったということだろうか。$k\n$Wsパイソン|$Wa$SvpV_RELIANCE_CLERBE_PAISON_B_08|$E悲,|いや、そもそもですね。$k$p$SvpV_RELIANCE_CLERBE_PAISON_B_09|平民だけど貴族と同じように\n見てあげなくっちゃ。$k$p$SvpV_RELIANCE_CLERBE_PAISON_B_10|$E通常,|……てのがもう平等じゃないんですよ。$k\n$Wsクレーベ|$Wa$SvpV_RELIANCE_CLERBE_PAISON_B_11|$E怒,汗|私は、お前たちを蔑んでいるわけでは……$k\n$Wsパイソン|$Wa$SvpV_RELIANCE_CLERBE_PAISON_B_12|$E通常,|それはわかってます。$k$p$SvpV_RELIANCE_CLERBE_PAISON_B_13|クレーベさまが\n悪いわけじゃありません。$k$p$SvpV_RELIANCE_CLERBE_PAISON_B_14|$E悲,|でも、俺たち平民が\n感じているいろんなことを$k$p$SvpV_RELIANCE_CLERBE_PAISON_B_15|本当に理解することはできないでしょ？$k\n$Wsクレーベ|$Wa$SvpV_RELIANCE_CLERBE_PAISON_B_16|$E悲,|……たしかにその通りだ。$k$p$SvpV_RELIANCE_CLERBE_PAISON_B_17|私は飢えや寒さを知らない。\n虐げられる者たちの屈辱も、絶望も……$k$p$SvpV_RELIANCE_CLERBE_PAISON_B_18|私が彼らに寄り添おうとしても\nそれは偽善でしかないのかもしれないな。$k\n$Wsパイソン|$Wa$SvpV_RELIANCE_CLERBE_PAISON_B_19|$E驚,|ちょっとお、\n落ち込まないでくださいよ。$k$p$SvpV_RELIANCE_CLERBE_PAISON_B_20|$E通常,|別に、そういうのを喜ぶやつも\nいっぱいいますよ。フォルスとか。$k$p$SvpV_RELIANCE_CLERBE_PAISON_B_21|ただ、俺みたいなやつもいるってだけで。$k$p$SvpV_RELIANCE_CLERBE_PAISON_B_22|$Eキメ,|ただの言いがかりです。\n忘れてください。$k\n$Wsクレーベ|$Wa$SvpV_RELIANCE_CLERBE_PAISON_B_23|$E悲,|パイソン……$k
MID_支援会話_クレーベ_パイソン_A	$t1$Wmパイソン|7$w0|$Wmクレーベ|3$w0|$Wsクレーベ|$Wa$SvpV_RELIANCE_CLERBE_PAISON_A_00|パイソン。$k\n$Wsパイソン|$Wa$E悲,|$SvpV_RELIANCE_CLERBE_PAISON_A_01|ああ、クレーベさま……\nもう元気になってくれました？$k$p$SvpV_RELIANCE_CLERBE_PAISON_A_02|あのあと大変だったんですから。$k$p$SvpV_RELIANCE_CLERBE_PAISON_A_03|クレーベさまが沈んでるのは\n俺に悪く言われたせいだって$k$p$SvpV_RELIANCE_CLERBE_PAISON_A_04|クレアさまからは槍で突っつかれるし\nみんなに詰め寄られるし……$k$p$E苦,汗|$SvpV_RELIANCE_CLERBE_PAISON_A_05|ほんと、\n勘弁してくださいよ。$k\n$Wsクレーベ|$Wa$SvpV_RELIANCE_CLERBE_PAISON_A_06|$E驚,|そ、それはすまなかったな。$k$p$SvpV_RELIANCE_CLERBE_PAISON_A_07|$E通常,|だが、私もあれから\n自分なりに考えてみたんだ。$k$p$SvpV_RELIANCE_CLERBE_PAISON_A_08|聞いてもらえないだろうか。$k\n$Wsパイソン|$Wa$E通常,|$SvpV_RELIANCE_CLERBE_PAISON_A_09|はあ……$k\n$Wsクレーベ|$Wa$SvpV_RELIANCE_CLERBE_PAISON_A_10|$E通常,|パイソン、私は……$k$p$SvpV_RELIANCE_CLERBE_PAISON_A_11|王があり、貴族があり\nその下に民があることこそ$k$p$SvpV_RELIANCE_CLERBE_PAISON_A_12|この国の正しい、\n秩序ある姿だと信じてきた。$k$p$SvpV_RELIANCE_CLERBE_PAISON_A_13|$E怒,|いや、正直に言おう。\nいまでもそう信じている。$k$p$SvpV_RELIANCE_CLERBE_PAISON_A_14|たとえそれを、\nお前が快く思わなくともだ。$k\n$Wsパイソン|$Wa$SvpV_RELIANCE_CLERBE_PAISON_A_15|$E通常,|……………………$k\n$Wsクレーベ|$Wa$SvpV_RELIANCE_CLERBE_PAISON_A_16|$E怒,|だが、それとお前という個人を\n軽んずることとは違う。$k$p$SvpV_RELIANCE_CLERBE_PAISON_A_17|貴族であろうと平民であろうと$k$p$SvpV_RELIANCE_CLERBE_PAISON_A_18|私にとってはかけがえのない盟友だ。$k$p$SvpV_RELIANCE_CLERBE_PAISON_A_19|$E悲,|それだけはわかってほしい。\n勝手な言い分かもしれないが……$k\n$Wsパイソン|$Wa$SvpV_RELIANCE_CLERBE_PAISON_A_20|$E笑,|……真面目だなあ、クレーベさまは。$k$p$SvpV_RELIANCE_CLERBE_PAISON_A_21|$E通常,|じゃあ俺も正直に言いますけど、\n王さまだの貴族だの$k$p$SvpV_RELIANCE_CLERBE_PAISON_A_22|身分だけで楽してるくせに\n人を見下すやつらは嫌いです。$k$p$SvpV_RELIANCE_CLERBE_PAISON_A_23|でも、クレーベさまのことも\n嫌いなのかっていわれたら$k$p$SvpV_RELIANCE_CLERBE_PAISON_A_24|それもちょっと違うんです。$k$p$SvpV_RELIANCE_CLERBE_PAISON_A_25|まあ、苦手ではありますけど。$k\n$Wsクレーベ|$Wa$SvpV_RELIANCE_CLERBE_PAISON_A_26|$E驚,|……苦手だったのか。$k\n$Wsパイソン|$Wa$SvpV_RELIANCE_CLERBE_PAISON_A_27|$E笑,|それくらいは許してくださいよ。$k$p$SvpV_RELIANCE_CLERBE_PAISON_A_28|$E通常,|あなたは飢えや寒さを\n知らないかわりに$k$p$SvpV_RELIANCE_CLERBE_PAISON_A_29|たくさんの人の命や生活を\nいつも本気で守ろうとしてる。$k$p$SvpV_RELIANCE_CLERBE_PAISON_A_30|だったらそれで\nいいんじゃないかって思います。$k$p$SvpV_RELIANCE_CLERBE_PAISON_A_31|$E悲,|だって、俺には絶対できないし。$k\n$Wsクレーベ|$Wa$SvpV_RELIANCE_CLERBE_PAISON_A_32|$E通常,|パイソン……$k\n$Wsパイソン|$Wa$SvpV_RELIANCE_CLERBE_PAISON_A_33|$E笑,|あなたの全部に\n賛成ってわけじゃないけど……$k$p$SvpV_RELIANCE_CLERBE_PAISON_A_34|いっしょに戦うのは\nやぶさかではないですよ。$k\n$Wsクレーベ|$Wa$SvpV_RELIANCE_CLERBE_PAISON_A_35|$E笑,|……それはよかった。\nありがとう、パイソン。$k$p$SvpV_RELIANCE_CLERBE_PAISON_A_36|$E通常,|この先にどんな未来が待つのか\n私にもわからないが……$k$p$SvpV_RELIANCE_CLERBE_PAISON_A_37|どんな立場の者にとっても\nよりよいものになるように$k$p$SvpV_RELIANCE_CLERBE_PAISON_A_38|これからも、どうかアルムに力を\n貸してやってくれ。$k\n$Wsパイソン|$Wa$E悲,汗|$SvpV_RELIANCE_CLERBE_PAISON_A_39|うーん、だからこういうのが\n苦手なんだけどな……$k$p$E笑,|$SvpV_RELIANCE_CLERBE_PAISON_A_40|まあいいや。\nはーい。$k
支援会話_クレーベ_フォルス.txt
MID_支援会話_クレーベ_フォルス_C	$t1$Wmフォルス|7$w0|$Wsフォルス|$Wa$SvpV_RELIANCE_CLERBE_FOLS_C_00|$E驚,|はっ、あれは……$k$p$SvpV_RELIANCE_CLERBE_FOLS_C_01|$E笑,|クレーベさま、クレーベさまー！！$k\n$Wmクレーベ|3$w0|$Wsクレーベ|$Wa$SvpV_RELIANCE_CLERBE_FOLS_C_02|$E通常,|フォルスか。\n調子はどうだ？$k\n$Wsフォルス|$Wa$SvpV_RELIANCE_CLERBE_FOLS_C_03|$E通常,|お任せください！\nかつてないほど絶好調であります！$k$p$SvpV_RELIANCE_CLERBE_FOLS_C_04|必ずやクレーベさまに\n勝利をお持ちしましょう！$k\n$Wsクレーベ|$Wa$SvpV_RELIANCE_CLERBE_FOLS_C_05|$E笑,|そうか、頼もしいな。$k$p$SvpV_RELIANCE_CLERBE_FOLS_C_06|$E通常,|勢いがあるのは結構だが、\nむやみに敵に深入りするんじゃないぞ。$k$p$SvpV_RELIANCE_CLERBE_FOLS_C_07|お前はそれで孤立して\n何度も助けられているだろう。$k\n$Wsフォルス|$Wa$SvpV_RELIANCE_CLERBE_FOLS_C_08|$E悲,汗|うっ……\n申し訳ありません。$k$p$SvpV_RELIANCE_CLERBE_FOLS_C_09|$E怒,|わかりました、クレーベさま！$k$p$SvpV_RELIANCE_CLERBE_FOLS_C_10|もし、またもや同じ過ちを\nくり返すようなことがあれば$k$p$SvpV_RELIANCE_CLERBE_FOLS_C_11|わが戦士生命を絶つ覚悟で\n臨む次第であります！$k\n$Wsクレーベ|$Wa$SvpV_RELIANCE_CLERBE_FOLS_C_12|$E苦,|いや、そこまでしなくてもいい。$k$p$SvpV_RELIANCE_CLERBE_FOLS_C_13|$E悲,|まったく……お前は優秀だが、\n思い込みが激しくていけないな。$k$p$SvpV_RELIANCE_CLERBE_FOLS_C_14|$E通常,|もっと肩の力を抜いたらどうだ？$k\n$Wsフォルス|$Wa$SvpV_RELIANCE_CLERBE_FOLS_C_15|$E驚,|はあ……\n肩の力をですか。$k$p$SvpV_RELIANCE_CLERBE_FOLS_C_16|$Eキメ,|了解しました！\n全力をもって善処いたします！$k\n$Wsクレーベ|$Wa$SvpV_RELIANCE_CLERBE_FOLS_C_17|$E悲,|……無理そうだな。$k
MID_支援会話_クレーベ_フォルス_B	$t1$Wmフォルス|7$w0|$Wmクレーベ|3$w0|$Wsクレーベ|$Wa$SvpV_RELIANCE_CLERBE_FOLS_B_00|$E通常,|フォルス。\n今日も調子がよさそうだな。$k\n$Wsフォルス|$Wa$SvpV_RELIANCE_CLERBE_FOLS_B_01|$E笑,|クレーベさま！$k$p$SvpV_RELIANCE_CLERBE_FOLS_B_02|$Eキメ,|はい、今日もわが解放軍と\nクレーベさまのために$k$p$SvpV_RELIANCE_CLERBE_FOLS_B_03|ひとりでも多くの敵を\n討ち倒す所存であります！$k\n$Wsクレーベ|$Wa$SvpV_RELIANCE_CLERBE_FOLS_B_04|$E苦,|そ、そうか。\nなあ、フォルス。$k$p$SvpV_RELIANCE_CLERBE_FOLS_B_05|$E通常,|先日、お前とパイソンが\n会話しているのを見て思ったんだが$k$p$SvpV_RELIANCE_CLERBE_FOLS_B_06|私にも、ああいうふうに\n接することはできないのか？$k\n$Wsフォルス|$Wa$SvpV_RELIANCE_CLERBE_FOLS_B_07|$E驚,|は？\n……と、申しますと……$k\n$Wsクレーベ|$Wa$SvpV_RELIANCE_CLERBE_FOLS_B_08|$E通常,|あのときのお前は、とても自然で\n打ち解けているように見えたんだ。$k$p$SvpV_RELIANCE_CLERBE_FOLS_B_09|肩の力を抜くというのは\nそういうことだ。$k$p$SvpV_RELIANCE_CLERBE_FOLS_B_10|$E笑,|どうだ、簡単だろう？$k\n$Wsフォルス|$Wa$SvpV_RELIANCE_CLERBE_FOLS_B_11|$E悲,汗|クレーベさまに、パイソンと\n接するように接する……$k$p$SvpV_RELIANCE_CLERBE_FOLS_B_12|…………………………\n…………………………$k\n$Wsクレーベ|$Wa$SvpV_RELIANCE_CLERBE_FOLS_B_13|$E悲,|……わかった、もういい。$k
MID_支援会話_クレーベ_フォルス_A	$t1$Wmフォルス|7$w0|$Wmクレーベ|3$w0|$Wsフォルス|$Wa$SvpV_RELIANCE_CLERBE_FOLS_A_00|$E悲,|クレーベさま…………$k\n$Wsクレーベ|$Wa$SvpV_RELIANCE_CLERBE_FOLS_A_01|$E驚,|どうしたんだ、フォルス？\nそんなに暗い顔をして……$k$p$SvpV_RELIANCE_CLERBE_FOLS_A_02|$E通常,|いつもの勢いはどこへいったんだ。$k\n$Wsフォルス|$Wa$SvpV_RELIANCE_CLERBE_FOLS_A_03|$E苦,|申し訳ありません……$k$p$SvpV_RELIANCE_CLERBE_FOLS_A_04|あれから、僕なりに\nクレーベさまのお心にかなうように$k$p$SvpV_RELIANCE_CLERBE_FOLS_A_05|試行錯誤を重ねてみたのですが……$k$p$SvpV_RELIANCE_CLERBE_FOLS_A_06|$E悲,|大した成果もなく\n行き詰ってしまいまして。$k\n$Wsクレーベ|$Wa$SvpV_RELIANCE_CLERBE_FOLS_A_07|$E驚,|試行錯誤？$k\n$Wsフォルス|$Wa$SvpV_RELIANCE_CLERBE_FOLS_A_08|$E悲,|はい。$k$p$SvpV_RELIANCE_CLERBE_FOLS_A_09|パイソンをクレーベさまだと思って\n会話を試みたのですが$k$p$SvpV_RELIANCE_CLERBE_FOLS_A_10|$E怒,|あいつがクレーベさまにあるまじき\n下品な言葉を並べたてるので$k$p$SvpV_RELIANCE_CLERBE_FOLS_A_11|$E悲,|思わず手が出て、\n殴り合いになってしまいました。$k$p$SvpV_RELIANCE_CLERBE_FOLS_A_12|ルカが止めてくれなかったら\nどうなっていたことか……$k\n$Wsクレーベ|$Wa$SvpV_RELIANCE_CLERBE_FOLS_A_13|$E悲,汗|そ、そうか。\nそれは困るな。$k\n$Wsフォルス|$Wa$SvpV_RELIANCE_CLERBE_FOLS_A_14|$E怒,汗|クレーベさま……\n今のままではだめでしょうか？$k$p$SvpV_RELIANCE_CLERBE_FOLS_A_15|あなたは、僕が幼い頃から憧れてきた\n騎士そのものなんです。$k$p$SvpV_RELIANCE_CLERBE_FOLS_A_16|$E悲,|あの、これだけ長くいっしょにいるのに\n笑わないでほしいんですけど$k$p$SvpV_RELIANCE_CLERBE_FOLS_A_17|お話しできるだけでも\n舞い上がってしまって……$k$p$SvpV_RELIANCE_CLERBE_FOLS_A_18|$E通常,|なにかと大げさになってしまうのは\nきっとそのせいなんです。$k$p$SvpV_RELIANCE_CLERBE_FOLS_A_19|だから……$k\n$Wsクレーベ|$Wa$SvpV_RELIANCE_CLERBE_FOLS_A_20|$E驚,|……なんだ、\nやればできるではないか。$k\n$Wsフォルス|$Wa$SvpV_RELIANCE_CLERBE_FOLS_A_21|$E驚,|は？\nな、なにがでしょう。$k\n$Wsクレーベ|$Wa$SvpV_RELIANCE_CLERBE_FOLS_A_22|$E通常,|気づいてないのか？\nまあいい。$k$p$SvpV_RELIANCE_CLERBE_FOLS_A_23|$E悲,|ただ、私はお前が憧れるような\n大したものではない。$k$p$SvpV_RELIANCE_CLERBE_FOLS_A_24|不甲斐ない姿も散々見せてきたつもりだ。$k$p$SvpV_RELIANCE_CLERBE_FOLS_A_25|$E通常,|そう思えばこそ、お前の大仰な態度が\n気になったのだが……$k\n$Wsフォルス|$Wa$E怒,|$SvpV_RELIANCE_CLERBE_FOLS_A_26|とんでもない！$k$p$SvpV_RELIANCE_CLERBE_FOLS_A_27|$E悲,|たしかに、ソフィア城を取り戻すまで\nわが解放軍は$k$p$SvpV_RELIANCE_CLERBE_FOLS_A_28|何度も苦境に立たされ\nもう駄目かと思うこともありました。$k$p$SvpV_RELIANCE_CLERBE_FOLS_A_29|$E通常,|ですが、そんな中でも\n僕たちが希望を失わずにいられたのは$k$p$SvpV_RELIANCE_CLERBE_FOLS_A_30|クレーベさまがいたからです。$k$p$SvpV_RELIANCE_CLERBE_FOLS_A_31|あなたは正しいと\n心から信じることができたからこそ$k$p$SvpV_RELIANCE_CLERBE_FOLS_A_32|僕たちは死をも恐れず戦うことができた。$k$p$SvpV_RELIANCE_CLERBE_FOLS_A_33|そりゃあ、いまの解放軍のリーダーは\nアルムですが……$k$p$SvpV_RELIANCE_CLERBE_FOLS_A_34|忘れないでください。$k$p$SvpV_RELIANCE_CLERBE_FOLS_A_35|僕の仰ぎ見る旗は\nいつだってクレーベさまのものです。$k\n$Wsクレーベ|$Wa$SvpV_RELIANCE_CLERBE_FOLS_A_36|$E笑,|フォルス……\nありがとう。$k$p$SvpV_RELIANCE_CLERBE_FOLS_A_37|$E通常,|私の不用意な言葉で\n悩ませてしまってすまなかったな。$k$p$SvpV_RELIANCE_CLERBE_FOLS_A_38|これからも\nお前の好きにするといい。$k\n$Wsフォルス|$Wa$SvpV_RELIANCE_CLERBE_FOLS_A_39|$E笑,|はっ……！\nありがたき幸せであります！！$k
支援会話_パイソン_ルカ.txt
MID_支援会話_パイソン_ルカ_C	$t1$Wmパイソン|7$w0|$Wmルカ|3$w0|$Wsパイソン|$Wa$SvpV_RELIANCE_PAISON_LUKA_C_00|$E苦,|ふああ……$k\n$Wsルカ|$Wa$SvpV_RELIANCE_PAISON_LUKA_C_01|$E通常,|おや、パイソン。\n大きなあくびですね。$k$p$SvpV_RELIANCE_PAISON_LUKA_C_02|昨日も朝にお帰りだったみたいですが……$k$p$SvpV_RELIANCE_PAISON_LUKA_C_03|$E悲,|私もそう何度も\n見て見ぬふりはできませんよ。$k$p$SvpV_RELIANCE_PAISON_LUKA_C_04|$E通常,|ほどほどにしてくださいね。$k\n$Wsパイソン|$Wa$SvpV_RELIANCE_PAISON_LUKA_C_05|$E笑,|へいへい。$k$p$SvpV_RELIANCE_PAISON_LUKA_C_06|$E苦,|あーあ、騎士さまは\nお堅くてやんなっちゃうね。$k$p$SvpV_RELIANCE_PAISON_LUKA_C_07|$E通常,|お前らもこう、\nパーッと遊んだりしねえの？$k\n$Wsルカ|$Wa$SvpV_RELIANCE_PAISON_LUKA_C_08|$E通常,|状況が状況ですからね。\n以前はどうだか知りませんが……$k\n$Wsパイソン|$Wa$SvpV_RELIANCE_PAISON_LUKA_C_09|$E驚,|お？\nなにそれ。$k$p$SvpV_RELIANCE_PAISON_LUKA_C_10|$E笑,|意外とクレーベさまも\n叩けば埃が出るってこと？$k\n$Wsルカ|$Wa$SvpV_RELIANCE_PAISON_LUKA_C_11|$E通常,|埃かどうかはわかりませんが、$k$p$SvpV_RELIANCE_PAISON_LUKA_C_12|宮中ではたいそう\nご婦人方の口に上ったそうですよ。$k\n$Wsパイソン|$Wa$SvpV_RELIANCE_PAISON_LUKA_C_13|$E怒,|なに、そのお上品なの……$k$p$SvpV_RELIANCE_PAISON_LUKA_C_14|$Eキメ,|そんなんじゃなくてさあ、\nもっと面白い話ないの？$k$p$SvpV_RELIANCE_PAISON_LUKA_C_15|クレーベさまったら不潔よ！\nとかみんながなるやつ。$k$p$SvpV_RELIANCE_PAISON_LUKA_C_16|なあなあ、教えろよー！\nちゃんと言いふらすから。$k\n$Wsルカ|$Wa$SvpV_RELIANCE_PAISON_LUKA_C_17|$E悲,|はあ……\n下世話ですねえ。$k
MID_支援会話_パイソン_ルカ_B	$t1$Wmパイソン|7$w0|$Wmルカ|3$w0|$Wsパイソン|$Wa$E通常,|$SvpV_RELIANCE_PAISON_LUKA_B_00|$E笑,|なあ、ルカ。$k\n$Wsルカ|$Wa$SvpV_RELIANCE_PAISON_LUKA_B_01|はい、なんでしょう？$k\n$Wsパイソン|$Wa$SvpV_RELIANCE_PAISON_LUKA_B_02|こないだの話だけどさ、\nお前はどうなのよ？$k\n$Wsルカ|$Wa$SvpV_RELIANCE_PAISON_LUKA_B_03|$E驚,|私ですか？$k$p$SvpV_RELIANCE_PAISON_LUKA_B_04|$E通常,|私は特に、お話できるようなことは\nありませんよ。$k\n$Wsパイソン|$Wa$SvpV_RELIANCE_PAISON_LUKA_B_05|$Eキメ,|嘘だあ。$k$p$SvpV_RELIANCE_PAISON_LUKA_B_06|町の女たちも、あの方はどなた？　とか\nすぐ俺に聞くぜ。$k$p$SvpV_RELIANCE_PAISON_LUKA_B_07|$E怒,|おかげで俺が面白くない思い\nしてるんだからさあ。$k$p$SvpV_RELIANCE_PAISON_LUKA_B_08|お詫びになんか教えてよ。$k\n$Wsルカ|$Wa$SvpV_RELIANCE_PAISON_LUKA_B_09|$E悲,|ずいぶん勝手な理屈ですが……\nうーん……$k$p$SvpV_RELIANCE_PAISON_LUKA_B_10|$E通常,|そうですね、故郷に長い付き合いの\n女性ならいますよ。$k\n$Wsパイソン|$Wa$SvpV_RELIANCE_PAISON_LUKA_B_11|$E驚,|わあ！\nそうなの？！$k$p$SvpV_RELIANCE_PAISON_LUKA_B_12|$E笑,|どんな女？　美人？　いくつくらい？\n将来どうすんの？$k\n$Wsルカ|$Wa$SvpV_RELIANCE_PAISON_LUKA_B_13|$E悲,|パイソン……\nまるで若い女性みたいですよ。$k$p$SvpV_RELIANCE_PAISON_LUKA_B_14|$E通常,|おや、敵の影が見えますね。\n行きましょう。$k\n$Wsルカ|$Wd$w0|$SspSE_EVT_4_HUMAN_RUN1_FLAT|$w2000|$Wsパイソン|$Wa$SvpV_RELIANCE_PAISON_LUKA_B_15|$E驚,|あっ、待てよ！\nおいってばー！！$k
MID_支援会話_パイソン_ルカ_A	$t1$Wmパイソン|7$w0|$Wmルカ|3$w0|$Wsパイソン|$Wa$SvpV_RELIANCE_PAISON_LUKA_A_00|$Eキメ,|ふふーん、ルカ！\nやーっと捕まえた。$k$p$SvpV_RELIANCE_PAISON_LUKA_A_01|さあさあ、お前の女について\n洗いざらい吐いてもらおうか。$k\n$Wsルカ|$Wa$SvpV_RELIANCE_PAISON_LUKA_A_02|$E悲,|吐けと言われましても……$k$p$SvpV_RELIANCE_PAISON_LUKA_A_03|$E通常,|本当に、お話しするようなことは\nなにもないんですよ。$k\n$Wsパイソン|$Wa$SvpV_RELIANCE_PAISON_LUKA_A_04|$E悲,|……あのさあ。\nこないだも思ったけど。$k$p$SvpV_RELIANCE_PAISON_LUKA_A_05|なに、その楽しくなさそうな感じ。\nその女のこと好きじゃないの？$k\n$Wsルカ|$Wa$SvpV_RELIANCE_PAISON_LUKA_A_06|$E悲,|正直に言いますと、\nわからないんですよ。$k$p$SvpV_RELIANCE_PAISON_LUKA_A_07|こうして離れていても\n特に会いたいとも思いませんし。$k$p$SvpV_RELIANCE_PAISON_LUKA_A_08|$E通常,|私は少し欠けているところが\nあるのかもしれませんね。$k$p$SvpV_RELIANCE_PAISON_LUKA_A_09|クレーベやマチルダを\n見ていると$k$p$SvpV_RELIANCE_PAISON_LUKA_A_10|ああいう情熱は、私の中には\nないのかもしれないと思います。$k\n$Wsパイソン|$Wa$SvpV_RELIANCE_PAISON_LUKA_A_11|$E苦,|おいおい……\nまだ若いのになに言ってんの。$k$p$SvpV_RELIANCE_PAISON_LUKA_A_12|$E通常,|まあ、ちょっとは\nわかる気がするけど。$k$p$SvpV_RELIANCE_PAISON_LUKA_A_13|でもさあ、別にそれが\n悪いってことはなくない？$k\n$Wsルカ|$Wa$SvpV_RELIANCE_PAISON_LUKA_A_14|$E驚,|そうでしょうか。$k\n$Wsパイソン|$Wa$SvpV_RELIANCE_PAISON_LUKA_A_15|$E通常,|そうだよ。$k$p$SvpV_RELIANCE_PAISON_LUKA_A_16|クレーベさまと\nマチルダさまみたいな$k$p$SvpV_RELIANCE_PAISON_LUKA_A_17|ああいう大げさなのだけが\n正解ってわけでもないだろうし……$k$p$SvpV_RELIANCE_PAISON_LUKA_A_18|$E笑,|お前だって、そのうちその女に\n会いたくなるかもしれないじゃん。$k$p$SvpV_RELIANCE_PAISON_LUKA_A_19|そうなったら\n会いに行けばいいんだよ。$k\n$Wsルカ|$Wa$SvpV_RELIANCE_PAISON_LUKA_A_20|$E通常,|パイソン……$k$p$SvpV_RELIANCE_PAISON_LUKA_A_21|そうですね、そうします。$k\n$Wsパイソン|$Wa$SvpV_RELIANCE_PAISON_LUKA_A_22|$Eキメ,|ま、とっくに他の男と\nくっついてるかもしれないけど。$k$p$SvpV_RELIANCE_PAISON_LUKA_A_23|そうなったら慰めてやるから\nいつでも言えよ。$k$p$SvpV_RELIANCE_PAISON_LUKA_A_24|$E笑,|パーッと遊びにいこうぜ。\nもちろんお前の金で。$k\n$Wsルカ|$Wa$SvpV_RELIANCE_PAISON_LUKA_A_25|$E笑,|ふふ……はい。\nそのときはよろしくお願いします。$k
支援会話_フォルス_ルカ.txt
MID_支援会話_フォルス_ルカ_C	$t1$Wmフォルス|7$w0|$Wmルカ|3$w0|$Wsルカ|$Wa$SvpV_RELIANCE_FOLS_LUKA_C_00|$E驚,|……フォルス？$k$p$SvpV_RELIANCE_FOLS_LUKA_C_01|驚きましたね。\nこんなところで読書ですか？$k\n$Wsフォルス|$Wa$SvpV_RELIANCE_FOLS_LUKA_C_02|$E驚,|うわっ……！$k$p$SvpV_RELIANCE_FOLS_LUKA_C_03|$E笑,汗|ややや……やあルカ！\n元気かい？$k\n$Wsルカ|$Wa$SvpV_RELIANCE_FOLS_LUKA_C_04|$E悲,|いまは戦闘中ですよ。\nさすがに危険なのではありませんか？$k\n$Wsフォルス|$Wa$SvpV_RELIANCE_FOLS_LUKA_C_05|$E悲,|……そうだな。\nまったくその通りだ。$k$p$SvpV_RELIANCE_FOLS_LUKA_C_06|$E怒,汗|だが、決して\nさぼっていた訳ではないんだ。$k$p$SvpV_RELIANCE_FOLS_LUKA_C_07|頼む、このことはクレーベさまには……！$k\n$Wsルカ|$Wa$SvpV_RELIANCE_FOLS_LUKA_C_08|$E通常,|言いませんよ。\n別に責めているわけではありません。$k$p$SvpV_RELIANCE_FOLS_LUKA_C_09|ところで、なにを読んでいたのです？$k\n$Wsフォルス|$Wa$SvpV_RELIANCE_FOLS_LUKA_C_10|$E通常,|ああ。\nこれは古い兵法書だよ。$k$p$SvpV_RELIANCE_FOLS_LUKA_C_11|家を出るときに、\n父の本棚から拝借したんだ。$k$p$SvpV_RELIANCE_FOLS_LUKA_C_12|$E笑,|僕の父は学者でね。\n小さいころから、本には事欠かないのさ。$k\n$Wsルカ|$Wa$SvpV_RELIANCE_FOLS_LUKA_C_13|$E驚,|へえ……\nそうだったんですか。$k$p$SvpV_RELIANCE_FOLS_LUKA_C_14|$E通常,|うらやましいです。\n私も読書は好きなんですよ。$k\n$Wsフォルス|$Wa$SvpV_RELIANCE_FOLS_LUKA_C_15|$E通常,|ああ、言われてみれば\nよく本を読んでいるのを見かけるな。$k\n$Wsルカ|$Wa$SvpV_RELIANCE_FOLS_LUKA_C_16|$E通常,|ええ。$k$p$SvpV_RELIANCE_FOLS_LUKA_C_17|$E悲,|ですが、子供のころは\n父が武芸の鍛錬ばかりさせたがって……$k$p$SvpV_RELIANCE_FOLS_LUKA_C_18|$E通常,|一度でいいから、一日中\nのんびり読書がしたいと思ったものです。$k\n$Wsフォルス|$Wa$SvpV_RELIANCE_FOLS_LUKA_C_19|$E驚,|……へえ。\nそういうものなのか。$k$p$SvpV_RELIANCE_FOLS_LUKA_C_20|$E悲,|……………………$k
MID_支援会話_フォルス_ルカ_B	$t1$Wmフォルス|7$w0|$Wmルカ|3$w0|$Wsルカ|$Wa$SvpV_RELIANCE_FOLS_LUKA_B_00|$E通常,|あの……フォルス。\nちょっといいですか？$k\n$Wsフォルス|$Wa$SvpV_RELIANCE_FOLS_LUKA_B_01|$E通常,|ああ、いいとも！\nどうしたんだい、ルカ。$k\n$Wsルカ|$Wa$SvpV_RELIANCE_FOLS_LUKA_B_02|先日、私の家の話をしたでしょう？$k$p$SvpV_RELIANCE_FOLS_LUKA_B_03|$E悲,|あのとき、あなたの顔が\n少し曇ったように見えたんですが……$k$p$SvpV_RELIANCE_FOLS_LUKA_B_04|なにか気に障るようなことを\n言ってしまったのでしょうか？$k\n$Wsフォルス|$Wa$SvpV_RELIANCE_FOLS_LUKA_B_05|$E悲,|……すまない、顔に出ていたのか。$k$p$SvpV_RELIANCE_FOLS_LUKA_B_06|$E通常,|いや、大したことじゃないんだ。$k$p$SvpV_RELIANCE_FOLS_LUKA_B_07|僕はルカとは逆に、\n幼いころから騎士になりたかったから$k$p$SvpV_RELIANCE_FOLS_LUKA_B_08|本当は勉強ばかりじゃなくて、\n剣や槍を教わりたかったんだ。$k\n$Wsルカ|$Wa$SvpV_RELIANCE_FOLS_LUKA_B_09|$E驚,|そうだったんですか……$k\n$Wsフォルス|$Wa$SvpV_RELIANCE_FOLS_LUKA_B_10|$E笑,|まあ、そんなことを教えてくれるあても\nなかったんだけどね。$k$p$SvpV_RELIANCE_FOLS_LUKA_B_11|$E通常,|だから、少しお前がうらやましかったのさ。$k\n$Wsルカ|$Wa$SvpV_RELIANCE_FOLS_LUKA_B_12|$E笑,|ふふっ、私でよければ\n喜んで代わってさし上げたのに。$k$p$SvpV_RELIANCE_FOLS_LUKA_B_13|$E通常,|上手くいかないものですね。$k\n$Wsフォルス|$Wa$SvpV_RELIANCE_FOLS_LUKA_B_14|$E笑,|ああ、まったくだ。$k
MID_支援会話_フォルス_ルカ_A	$t1$Wmフォルス|7$w0|$Wmルカ|3$w0|$Wsルカ|$Wa$SvpV_RELIANCE_FOLS_LUKA_A_00|$E悲,|フォルス……$k$p$SvpV_RELIANCE_FOLS_LUKA_A_01|また戦闘中に読書ですか？\n危ないといったでしょう。$k\n$Wsフォルス|$Wa$SvpV_RELIANCE_FOLS_LUKA_A_02|$E驚,|うわっと……！$k$p$SvpV_RELIANCE_FOLS_LUKA_A_03|$E笑,汗|や、やあルカ。\n今日も壮健そうでなによりだ！$k\n$Wsルカ|$Wa$SvpV_RELIANCE_FOLS_LUKA_A_04|$E通常,|それはどうも。\n今度はなにを読んでいるんです？$k\n$Wsフォルス|$Wa$SvpV_RELIANCE_FOLS_LUKA_A_05|$E通常,|これはソフィアの歴史について\n書かれた本さ。$k$p$SvpV_RELIANCE_FOLS_LUKA_A_06|実は、この間はああいったものの\n少し後悔もしているんだ。$k\n$Wsルカ|$Wa$SvpV_RELIANCE_FOLS_LUKA_A_07|$E驚,|後悔？$k\n$Wsフォルス|$Wa$SvpV_RELIANCE_FOLS_LUKA_A_08|ああ。$k$p$SvpV_RELIANCE_FOLS_LUKA_A_09|勉学の中にも、戦に生かせるものは\nたくさんあるだろう？$k$p$SvpV_RELIANCE_FOLS_LUKA_A_10|子供だった僕はそれに気づけなくて……\nもったいないことをしたと思ってさ。$k$p$SvpV_RELIANCE_FOLS_LUKA_A_11|$E悲,|現に、こうしてクレーベさまの\n副官となった今は$k$p$SvpV_RELIANCE_FOLS_LUKA_A_12|己の無学さに打ちひしがれる毎日だ。$k\n$Wsルカ|$Wa$SvpV_RELIANCE_FOLS_LUKA_A_13|$E通常,|フォルス……$k$p$SvpV_RELIANCE_FOLS_LUKA_A_14|$E笑,|私も、もっと真面目に\n稽古を受けていればよかったと$k$p$SvpV_RELIANCE_FOLS_LUKA_A_15|死にかけるたびに思いますよ。$k$p$SvpV_RELIANCE_FOLS_LUKA_A_16|$E通常,|でも、今からでも\nきっと遅くはありません。$k\n$Wsフォルス|$Wa$SvpV_RELIANCE_FOLS_LUKA_A_17|$E通常,|そうだな……\nうん、その通りだ。$k$p$SvpV_RELIANCE_FOLS_LUKA_A_18|$E笑,|よし、ルカ！\n見ていてくれたまえ。$k$p$SvpV_RELIANCE_FOLS_LUKA_A_19|僕は教養も武芸も、\n誰にも負けない騎士になってみせるよ！$k\n$Wsルカ|$Wa$SvpV_RELIANCE_FOLS_LUKA_A_20|$E笑,|ええ、フォルスならきっとなれますよ。\n楽しみにしています。$k
