strings
SYS_DIALOG_GENERIC_BUTTON1	
SYS_DIALOG_GENERIC_BUTTON2	
SYS_DIALOG_GENERIC_BUTTON3	
SYS_DIALOG_GENERIC_ITEM_OK	確定
SYS_DIALOG_GENERIC_ITEM_YES	是
SYS_DIALOG_GENERIC_ITEM_NO	否
SYS_DIALOG_GENERIC_ITEM_CANCEL	退出
SYS_DIALOG_GENERIC_ITEM_INVITE	邀請朋友
SYS_DIALOG_GENERIC_ITEM_LATER	稍後
SYS_DIALOG_SAVE_CONFIRMATION_TEXT	是否要覆寫？
SYS_DIALOG_SAVE_PROCESSING_TEXT	正在儲存
SYS_DIALOG_SAVE_COMPLETED_TEXT	已經儲存。
SYS_DIALOG_SAVE_FAILED_TEXT	儲存失敗。
SYS_DIALOG_EXCHANGE_PLAYER_1P_TEXT	已經更換1P與2P。\n您成為了1P。\n選單將由繼續操作。
SYS_DIALOG_EXCHANGE_PLAYER_2P_TEXT	已經更換1P與2P。\n您成為了2P。\n選單將由繼續操作。
SYS_DIALOG_ONLINE_CONTROLLER_TEXT	可以在線上使用的控制器為1個。\n是否要繼續？
SYS_DIALOG_ONLINE_CONNECTING_TEXT	正在連接網路。
SYS_DIALOG_ONLINE_SEARCHING_TEXT	正在尋找在等待的朋友。
SYS_DIALOG_ONLINE_CREATE_SESSION_TEXT	是否要設定暗號？\n只有知道暗號的朋友可以一起遊玩。
SYS_DIALOG_ONLINE_CREATE_SESSION_WITHOUT_PASSWORD	沒有暗號
SYS_DIALOG_ONLINE_CREATE_SESSION_WITH_PASSWORD	 有暗號
SYS_DIALOG_ONLINE_CREATING_SESSION_TEXT	正在準備線上遊玩。
SYS_DIALOG_ONLINE_CREATED_SESSION_TEXT	朋友來會合便會通知。\n您可在等待的同時遊玩。
SYS_DIALOG_ONLINE_CREATED_SESSION_TEXT_INVITE	要立刻邀請朋友嗎？\n如果選擇稍後，可在左側選單邀請。
SYS_DIALOG_ONLINE_CREATED_SESSION_SORT_TEXT	朋友來會合便會通知。\n您可在等待的同時遊玩。\n作品的排序會暫時更改為「按喜愛順序」。
SYS_DIALOG_ONLINE_CREATED_SESSION_SORT_TEXT_INVITE	作品的排序會暫時更改為「按喜愛順序」。\n\n要立刻邀請朋友嗎？\n如果選擇稍後，可在左側選單邀請。
SYS_DIALOG_ONLINE_PASSWORD_MISMATCH_TEXT	暗號錯誤。
SYS_DIALOG_ONLINE_FAILED_TO_JOIN_TEXT	與朋友會合失敗。
SYS_DIALOG_ONLINE_WAITING_FOR_GUEST_TEXT	正在與會合。
SYS_DIALOG_ONLINE_WAITING_FOR_HOST_TEXT	正在與會合。\n（不會更改您的儲存資料）
SYS_DIALOG_ONLINE_ESTABLISHED_HOST_TEXT	過來遊玩了。\n選單將由操作。\n通訊品質依據您與對方的通訊環境而定。
SYS_DIALOG_ONLINE_ESTABLISHED_GUEST_TEXT	您來到的地方遊玩。\n選單將由操作。\n通訊品質依據您與對方的通訊環境而定。
SYS_DIALOG_QUIT_ONLINE_PLAY_TEXT	將退出線上遊玩。\n是否確定？
SYS_DIALOG_DURING_GUEST_OPERATION_TEXT	正在操作。
SYS_DIALOG_DURING_HOST_OPERATION_TEXT	正在操作。
SYS_DIALOG_LEAVING_ONLINE_PLAY_TEXT	正在結束線上遊玩。
SYS_DIALOG_NEW_ARRIVAL_INFORMATION_TEXT	新增了作品。
SYS_DIALOG_ERROR_EMULATOR_CRASHED_TEXT	遊戲中發生了錯誤。
SYS_DIALOG_ONLINE_PAUSE_ON_DISCONNECT_TEXT	已經與切斷通訊。\n遊戲將無法繼續。\n只允許隨時隨地儲存。
SYS_DIALOG_ONLINE_TITLE_PROHIBITED_TEXT	無法選擇此作品。
SYS_DIALOG_NETPLAY_TO_OPTIONAL_MODE_TEXT	已經開啟低延遲通訊模式。\n雖然線上遊玩時的操作延遲現象會減緩，\n但是可能會影響到聲音和圖像。\n（不會儲存此設定）
SYS_DIALOG_NETPLAY_TO_PRIMARY_MODE_TEXT	已經關閉低延遲通訊模式。\n（不會儲存此設定）
SYS_DIALOG_PROMOTION_02_INFO_TEXT	通知
SYS_DIALOG_PROMOTION_02_MAIN_TITLE	Nintendo Switch Online加入者專屬的\nSuper Famicom控制器已發售
SYS_DIALOG_PROMOTION_03_MAIN_TITLE	超級瑪利歐兄弟\n35週年特別發布
SYS_DIALOG_PROMOTION_02_MAIN_TEXT	外形、大小完全重現Super Famicom控制器的「Super Famicom控制器」。\n讓你能以那時的感覺遊玩《Super Famicom Nintendo Switch Online》。
SYS_DIALOG_PROMOTION_03_MAIN_TEXT	1985年9月13日發售的《超級瑪利歐兄弟》，在2020年迎接35週年，\n為配合這個重要時刻，將發布《超級瑪利歐收藏輯》。\n還請品味畫面、聲音的品質比起Family Computer時更加提升的\n《超級瑪利歐兄弟》《超級瑪利歐兄弟2》《超級瑪利歐兄弟3》\n《超級瑪利歐兄弟USA》。
SYS_DIALOG_PROMOTION_01_SUB_TITLE	前往購買
SYS_DIALOG_PROMOTION_02_SUB_TEXT	※未在部分國家／地區推出。\n詳情請查閱任天堂官網。
SYS_DIALOG_PROMOTION_03_SUB_TEXT	在任天堂官網上有超級瑪利歐兄弟35週年相關新作軟體和促銷資訊等介紹。
SYS_HUD_GUIDE_PRO_CONFIRM	  確定
SYS_HUD_GUIDE_PRO_BACK	  返回
SYS_HUD_GUIDE_PRO_DETAILS	  詳情
SYS_HUD_GUIDE_PRO_MOVE	  移動
SYS_HUD_GUIDE_PRO_MOVE2	  移動（長按則排序）
SYS_HUD_GUIDE_PRO_SORT	  長按則排序
SYS_HUD_GUIDE_PRO_PLAY	  開始
SYS_HUD_GUIDE_PRO_INVITE	  邀請朋友
SYS_HUD_GUIDE_PRO_Invitation	  邀請朋友
SYS_HUD_GUIDE_PRO_GUIDE	  操作指南
SYS_HUD_GUIDE_PRO_EXCHANGE	  更換1P/2P
SYS_HUD_GUIDE_PRO_VOICE_CHAT	  如何語音聊天？
SYS_HUD_GUIDE_PRO_PROMOTION	  關於專用控制器
SYS_HUD_GUIDE_PRO_INGAME_PAUSE	 +   中斷選單
SYS_HUD_GUIDE_PRO_INGAME_START	  START鍵
SYS_HUD_GUIDE_PRO_INGAME_SELECT	  SELECT鍵
SYS_HUD_GUIDE_PRO_INGAME_QUIT_ONLINE	 +   退出線上遊玩
SYS_HUD_GUIDE_PRO_DETAILES_NEXT	  繼續
SYS_HUD_GUIDE_PRO_COMMIT	  確定
SYS_HUD_GUIDE_PRO_CANCEL	  復原
SYS_HUD_GUIDE_PRO_NETPLAY_OPTIONAL_MODE	  開啟低延遲通訊模式
SYS_HUD_GUIDE_PRO_NETPLAY_PRIMARY_MODE	  關閉低延遲通訊模式
SYS_HUD_GUIDE_JOY_L_CONFIRM	  確定
SYS_HUD_GUIDE_JOY_R_CONFIRM	  確定
SYS_HUD_GUIDE_JOY_L_BACK	  返回
SYS_HUD_GUIDE_JOY_R_BACK	  返回
SYS_HUD_GUIDE_JOY_L_DETAILS	  詳情
SYS_HUD_GUIDE_JOY_R_DETAILS	  詳情
SYS_HUD_GUIDE_JOY_L_MOVE	  移動
SYS_HUD_GUIDE_JOY_L_MOVE2	  移動（長按則排序）
SYS_HUD_GUIDE_JOY_L_SORT	  長按則排序
SYS_HUD_GUIDE_JOY_R_MOVE	  移動
SYS_HUD_GUIDE_JOY_R_MOVE2	  移動（長按則排序）
SYS_HUD_GUIDE_JOY_R_SORT	  長按則排序
SYS_HUD_GUIDE_JOY_L_PLAY	  開始
SYS_HUD_GUIDE_JOY_R_PLAY	  開始
SYS_HUD_GUIDE_JOY_L_GUIDE	  操作指南
SYS_HUD_GUIDE_JOY_R_GUIDE	  操作指南
SYS_HUD_GUIDE_JOY_L_EXCHANGE	  更換1P/2P
SYS_HUD_GUIDE_JOY_R_EXCHANGE	  更換1P/2P
SYS_HUD_GUIDE_JOY_L_VOICE_CHAT	  如何進行語音聊天？
SYS_HUD_GUIDE_JOY_R_VOICE_CHAT	  如何進行語音聊天？
SYS_HUD_GUIDE_JOY_L_PROMOTION	  關於專用控制器
SYS_HUD_GUIDE_JOY_R_PROMOTION	  關於專用控制器
SYS_HUD_GUIDE_JOY_L_INGAME_PAUSE	 +   中斷選單
SYS_HUD_GUIDE_JOY_R_INGAME_PAUSE	 +   中斷選單
SYS_HUD_GUIDE_JOY_L_INGAME_START	 +   START鍵
SYS_HUD_GUIDE_JOY_R_INGAME_START	 +   START鍵
SYS_HUD_GUIDE_JOY_L_INGAME_SELECT	 +   SELECT鍵
SYS_HUD_GUIDE_JOY_R_INGAME_SELECT	 +   SELECT鍵
SYS_HUD_GUIDE_JOY_L_INGAME_QUIT_ONLINE	 +   退出線上遊玩
SYS_HUD_GUIDE_JOY_R_INGAME_QUIT_ONLINE	 +   退出線上遊玩
SYS_HUD_GUIDE_JOY_L_DETAILS_NEXT	  繼續
SYS_HUD_GUIDE_JOY_R_DETAILS_NEXT	  繼續
SYS_HUD_GUIDE_JOY_L_COMMIT	  確定
SYS_HUD_GUIDE_JOY_R_COMMIT	  確定
SYS_HUD_GUIDE_JOY_L_CANCEL	  復原
SYS_HUD_GUIDE_JOY_R_CANCEL	  復原
SYS_HUD_GUIDE_JOY_L_NETPLAY_OPTIONAL_MODE	  開啟低延遲通訊模式
SYS_HUD_GUIDE_JOY_R_NETPLAY_OPTIONAL_MODE	  開啟低延遲通訊模式
SYS_HUD_GUIDE_JOY_L_NETPLAY_PRIMARY_MODE	  關閉低延遲通訊模式
SYS_HUD_GUIDE_JOY_R_NETPLAY_PRIMARY_MODE	  關閉低延遲通訊模式
SYS_HUD_GUIDE_LARK_HOME	  HOME選單
SYS_HUD_GUIDE_LARK_HOME2	 : 
SYS_HUD_GUIDE_LARK_R_HOME	  HOME選單
SYS_HUD_GUIDE_LARK_R_HOME2	 : 
SYS_HUD_GUIDE_LUCIA_HOME	  HOME選單
SYS_HUD_GUIDE_LUCIA_HOME2	 : 
SYS_HUD_GUIDE_LARK_CAPTURE	  拍攝
SYS_HUD_GUIDE_LARK_CAPTURE2	 : 
SYS_HUD_GUIDE_LARK_L_CAPTURE	  拍攝
SYS_HUD_GUIDE_LARK_L_CAPTURE2	 : 
SYS_HUD_GUIDE_LUCIA_CAPTURE	  拍攝
SYS_HUD_GUIDE_LUCIA_CAPTURE2	 : 
SYS_HUD_GUIDE_LARK_CONFIRM	  確定
SYS_HUD_GUIDE_LARK_BACK	  返回
SYS_HUD_GUIDE_LARK_DETAILS	  詳情
SYS_HUD_GUIDE_LARK_MOVE	  移動
SYS_HUD_GUIDE_LARK_MOVE2	  移動（長按則排序）
SYS_HUD_GUIDE_LARK_SORT	  長按則排序
SYS_HUD_GUIDE_LARK_PLAY	  開始
SYS_HUD_GUIDE_LARK_GUIDE	  操作指南
SYS_HUD_GUIDE_LARK_EXCHANGE	  更換1P/2P
SYS_HUD_GUIDE_LARK_VOICE_CHAT	  如何進行語音聊天？
SYS_HUD_GUIDE_LARK_PROMOTION	  關於專用控制器
SYS_HUD_GUIDE_LARK_INGAME_PAUSE	 +   中斷選單
SYS_HUD_GUIDE_LARK_INGAME_QUIT_ONLINE	 +   退出線上遊玩
SYS_HUD_GUIDE_LARK_DETAILES_NEXT	  繼續
SYS_HUD_GUIDE_LARK_COMMIT	  確定
SYS_HUD_GUIDE_LARK_CANCEL	  復原
SYS_HUD_GUIDE_LARK_NETPLAY_OPTIONAL_MODE	  開啟低延遲通訊模式
SYS_HUD_GUIDE_LARK_NETPLAY_PRIMARY_MODE	  關閉低延遲通訊模式
SYS_HUD_GUIDE_LARK_L_CONFIRM	  確定
SYS_HUD_GUIDE_LARK_L_BACK	  返回
SYS_HUD_GUIDE_LARK_L_DETAILS	  詳情
SYS_HUD_GUIDE_LARK_L_MOVE	  移動
SYS_HUD_GUIDE_LARK_L_MOVE2	  移動（長按則排序）
SYS_HUD_GUIDE_LARK_L_SORT	  長按則排序
SYS_HUD_GUIDE_LARK_L_PLAY	  開始
SYS_HUD_GUIDE_LARK_L_GUIDE	  操作指南
SYS_HUD_GUIDE_LARK_L_EXCHANGE	  更換1P/2P
SYS_HUD_GUIDE_LARK_L_VOICE_CHAT	  如何進行語音聊天？
SYS_HUD_GUIDE_LARK_L_PROMOTION	  關於專用控制器
SYS_HUD_GUIDE_LARK_L_INGAME_PAUSE	  中斷選單
SYS_HUD_GUIDE_LARK_L_INGAME_START	  START鍵
SYS_HUD_GUIDE_LARK_L_INGAME_SELECT	  SELECT鍵
SYS_HUD_GUIDE_LARK_L_INGAME_QUIT_ONLINE	  退出線上遊玩
SYS_HUD_GUIDE_LARK_L_DETAILES_NEXT	  繼續
SYS_HUD_GUIDE_LARK_L_COMMIT	  確定
SYS_HUD_GUIDE_LARK_L_CANCEL	  復原
SYS_HUD_GUIDE_LARK_L_NETPLAY_OPTIONAL_MODE	  開啟低延遲通訊模式
SYS_HUD_GUIDE_LARK_L_NETPLAY_PRIMARY_MODE	  關閉低延遲通訊模式
SYS_HUD_GUIDE_LARK_R_CONFIRM	  確定
SYS_HUD_GUIDE_LARK_R_BACK	  返回
SYS_HUD_GUIDE_LARK_R_DETAILS	  詳情
SYS_HUD_GUIDE_LARK_R_MOVE	  移動
SYS_HUD_GUIDE_LARK_R_MOVE2	  移動（長按則排序）
SYS_HUD_GUIDE_LARK_R_SORT	  長按則排序
SYS_HUD_GUIDE_LARK_R_PLAY	  開始
SYS_HUD_GUIDE_LARK_R_GUIDE	  操作指南
SYS_HUD_GUIDE_LARK_R_EXCHANGE	  更換1P/2P
SYS_HUD_GUIDE_LARK_R_VOICE_CHAT	  如何進行語音聊天？
SYS_HUD_GUIDE_LARK_R_PROMOTION	  關於專用控制器
SYS_HUD_GUIDE_LARK_R_INGAME_PAUSE	  中斷選單
SYS_HUD_GUIDE_LARK_R_INGAME_START	  START鍵
SYS_HUD_GUIDE_LARK_R_INGAME_SELECT	  SELECT鍵
SYS_HUD_GUIDE_LARK_R_INGAME_QUIT_ONLINE	  退出線上遊玩
SYS_HUD_GUIDE_LARK_R_DETAILES_NEXT	  繼續
SYS_HUD_GUIDE_LARK_R_COMMIT	  確定
SYS_HUD_GUIDE_LARK_R_CANCEL	  復原
SYS_HUD_GUIDE_LARK_R_NETPLAY_OPTIONAL_MODE	  開啟低延遲通訊模式
SYS_HUD_GUIDE_LARK_R_NETPLAY_PRIMARY_MODE	  關閉低延遲通訊模式
SYS_HUD_GUIDE_LARK_LR_CONFIRM	  確定
SYS_HUD_GUIDE_LARK_LR_BACK	  返回
SYS_HUD_GUIDE_LARK_LR_DETAILS	  詳情
SYS_HUD_GUIDE_LARK_LR_MOVE	  移動
SYS_HUD_GUIDE_LARK_LR_MOVE2	  移動（長按則排序）
SYS_HUD_GUIDE_LARK_LR_SORT	  長按則排序
SYS_HUD_GUIDE_LARK_LR_PLAY	  開始
SYS_HUD_GUIDE_LARK_LR_GUIDE	  操作指南
SYS_HUD_GUIDE_LARK_LR_EXCHANGE	  更換1P/2P
SYS_HUD_GUIDE_LARK_LR_VOICE_CHAT	  如何進行語音聊天？
SYS_HUD_GUIDE_LARK_LR_PROMOTION	  關於專用控制器
SYS_HUD_GUIDE_LARK_LR_INGAME_PAUSE	  中斷選單
SYS_HUD_GUIDE_LARK_LR_INGAME_START	  START鍵
SYS_HUD_GUIDE_LARK_LR_INGAME_SELECT	  SELECT鍵
SYS_HUD_GUIDE_LARK_LR_INGAME_QUIT_ONLINE	  退出線上遊玩
SYS_HUD_GUIDE_LARK_LR_DETAILES_NEXT	  繼續
SYS_HUD_GUIDE_LARK_LR_COMMIT	  確定
SYS_HUD_GUIDE_LARK_LR_CANCEL	  復原
SYS_HUD_GUIDE_LARK_LR_NETPLAY_OPTIONAL_MODE	  開啟低延遲通訊模式
SYS_HUD_GUIDE_LARK_LR_NETPLAY_PRIMARY_MODE	  關閉低延遲通訊模式
SYS_HUD_GUIDE_LUCIA_CONFIRM	  確定
SYS_HUD_GUIDE_LUCIA_BACK	  返回
SYS_HUD_GUIDE_LUCIA_DETAILS	  詳情
SYS_HUD_GUIDE_LUCIA_MOVE	  移動
SYS_HUD_GUIDE_LUCIA_MOVE2	  移動 （長按則排序）
SYS_HUD_GUIDE_LUCIA_SORT	  長按則排序
SYS_HUD_GUIDE_LUCIA_PLAY	  開始
SYS_HUD_GUIDE_LUCIA_GUIDE	  操作指南
SYS_HUD_GUIDE_LUCIA_EXCHANGE	  更換1P/2P
SYS_HUD_GUIDE_LUCIA_VOICE_CHAT	  如何語音聊天？
SYS_HUD_GUIDE_LUCIA_PROMOTION	  關於專用控制器
SYS_HUD_GUIDE_LUCIA_INGAME_PAUSE	 +   中斷選單
SYS_HUD_GUIDE_LUCIA_INGAME_QUIT_ONLINE	 +   退出線上遊玩
SYS_HUD_GUIDE_LUCIA_DETAILES_NEXT	  繼續
SYS_HUD_GUIDE_LUCIA_COMMIT	  確定
SYS_HUD_GUIDE_LUCIA_CANCEL	  復原
SYS_HUD_GUIDE_LUCIA_NETPLAY_OPTIONAL_MODE	  開啟低延遲通訊模式
SYS_HUD_GUIDE_LUCIA_NETPLAY_PRIMARY_MODE	  關閉低延遲通訊模式
SYS_INFO_NICKNAME_OWN	
SYS_INFO_NICKNAME_HOST	
SYS_INFO_NICKNAME_GUEST	
SYS_INFO_ROLE_PLAYER1	1P
SYS_INFO_ROLE_PLAYER2	2P
SYS_INFO_SESSION_PASSWORD	
SYS_INFO_NETWORK_UNSTABLE	您可以在「 設定」更改通訊模式
SYS_MENU_ROOT_ITEM_ONE_PLAYER	單人遊玩
SYS_MENU_ROOT_ITEM_TWO_PLAYERS	雙人遊玩
SYS_MENU_ROOT_ITEM_ONLINE_PLAY	線上遊玩
SYS_MENU_ROOT_ITEM_STOP_ONLINE_PLAY	退出線上遊玩
SYS_MENU_ROOT_ITEM_SETTINGS	設定
SYS_MENU_ROOT_ITEM_INVITE	邀請朋友
SYS_MENU_ROOT_SESSION_COUNTER	
SYS_MENU_ONLINE_GUIDE_SUBJECT	線上遊玩
SYS_MENU_ONLINE_GUIDE_DESC1	＊可以在線上和朋友兩個人一起遊玩。\n\n＊可以先獨自遊玩並等待朋友上線。\n\n＊有智慧型手機應用程式「Nintendo Switch Online」\n　便可以使用語音聊天。
SYS_MENU_ONLINE_ITEM_CREATE_SESSION	遊玩並等待
SYS_MENU_ONLINE_ITEM_SESSION1	
SYS_MENU_ONLINE_ITEM_SESSION2	
SYS_MENU_ONLINE_ITEM_SESSION3	
SYS_MENU_ONLINE_ITEM_SESSION4	
SYS_MENU_ONLINE_ITEM_SESSION5	
SYS_MENU_ONLINE_ITEM_SESSION6	
SYS_MENU_ONLINE_ITEM_PLAYING	正在遊玩
SYS_MENU_ONLINE_DESC_CREATE_SESSION	獨自遊玩並等待朋友
SYS_MENU_ONLINE_DESC_CREATE_SESSION_INVITE	遊玩並等待朋友\n也可以邀請朋友
SYS_MENU_ONLINE_DESC_SESSION_LIST	選擇要一起遊玩的朋友　 重新搜尋
SYS_MENU_ONLINE_DESC_SESSION_LIST_JOY_L	選擇要一起遊玩的朋友　 重新搜尋
SYS_MENU_ONLINE_DESC_SESSION_LIST_JOY_R	選擇要一起遊玩的朋友　 重新搜尋
SYS_MENU_ONLINE_DESC_SESSION_LIST_LARK	選擇要一起遊玩的朋友　 重新搜尋
SYS_MENU_ONLINE_DESC_SESSION_LIST_LARK_L	選擇要一起遊玩的朋友　 重新搜尋
SYS_MENU_ONLINE_DESC_SESSION_LIST_LARK_R	選擇要一起遊玩的朋友　 重新搜尋
SYS_MENU_ONLINE_DESC_SESSION_LIST_LARK_LR	選擇要一起遊玩的朋友　 重新搜尋
SYS_MENU_ONLINE_DESC_SESSION_LIST_LUCIA	選擇要一起遊玩的朋友　 重新搜尋
SYS_MENU_ONLINE_DESC_SESSION_LIST_INVITE	選擇要會合的朋友　 重新搜尋
SYS_MENU_ONLINE_DESC_SESSION_LIST_JOY_L_INVITE	選擇要會合的朋友　 重新搜尋
SYS_MENU_ONLINE_DESC_SESSION_LIST_JOY_R_INVITE	選擇要會合的朋友　 重新搜尋
SYS_MENU_ONLINE_DESC_SESSION_LIST_LARK_INVITE	選擇要會合的朋友　 重新搜尋
SYS_MENU_ONLINE_DESC_SESSION_LIST_LARK_L_INVITE	選擇要會合的朋友　 重新搜尋
SYS_MENU_ONLINE_DESC_SESSION_LIST_LARK_R_INVITE	選擇要會合的朋友　 重新搜尋
SYS_MENU_ONLINE_DESC_SESSION_LIST_LARK_LR_INVITE	選擇要會合的朋友　 重新搜尋
SYS_MENU_ONLINE_DESC_SESSION_LIST_LUCIA_INVITE	選擇要會合的朋友　 重新搜尋
SYS_MENU_ONLINE_NOTICE_NOT_FOUND	沒有可以一起遊玩的朋友
SYS_MENU_ONLINE_NOTICE_NOT_FOUND_INVITE	沒有一起遊玩的朋友
SYS_MENU_ONLINE_KEYBOARD_HEADER	請輸入暗號（3位數）
SYS_MENU_ONLINE_KEYBOARD_GUIDE	3位數的數字
SYS_MENU_SETTINGS_ITEM_4_3	4:3
SYS_MENU_SETTINGS_ITEM_PIXEL_PERFECT	原始比例
SYS_MENU_SETTINGS_ITEM_CRT	映像管電視
SYS_MENU_SETTINGS_DESC_GAME_SCREEN	遊戲畫面
SYS_MENU_SETTINGS_DESC_GUIDE_DISPLAY	遊戲中的按鍵定義顯示
SYS_MENU_SETTINGS_ITEM_GUIDE_DISPLAY	顯示
SYS_MENU_PAUSE_ITEM_CONTINUE	繼續
SYS_MENU_PAUSE_ITEM_LOAD	載入
SYS_MENU_PAUSE_ITEM_SAVE	隨時隨地儲存
SYS_MENU_PAUSE_ITEM_RESET	重置
SYS_MENU_PAUSE_ITEM_RETURN_TO_MENU	返回選擇作品畫面
SYS_MENU_DETAILS_DESC_RELEASE_INFO	　　年發售
SYS_MENU_DETAILS_DESC_PLAY_INFO_LONG_TIME	遊玩人數：人　　遊玩時間：小時分鐘
SYS_MENU_DETAILS_DESC_PLAY_INFO_SHORT_TIME	遊玩人數：人　　遊玩時間：分鐘
SYS_MENU_DETAILS_DESC_PLAY_INFO_NO_TIME	遊玩人數：人
SYS_MENU_DETAIL_PAGE	 / 
SYS_MENU_SAVESLOT_NO_IMAGE	No Data
SYS_MENU_SAVESLOT_ITEM_EMPTY	儲存資料
SYS_MENU_SAVESLOT_ITEM_VALID	儲存資料\n// :
SYS_MENU_SORT_INDEX	●
SYS_MENU_SORT_INDEX_00	〇
SYS_MENU_SPECIAL_EMBLEM	SP
SYS_MENU_SPECIAL_TEXT	SPECIAL
SYS_MENU_SPECIAL2_TEXT	SPECIAL
SYS_MENU_NEW_GAME_TEXT	NEW
SYS_MENU_FRIENDPRESENCE	正在遊玩的遊戲：
SYS_NOTIFICATION_QUIT_ONLINE_PLAY_TEXT	已退出線上遊玩。
SYS_NOTIFICATION_OTHER_PLAYER_MISSING_TEXT	已與切斷通訊。\n將繼續遊玩並等待朋友。
SYS_NOTIFICATION_OTHER_PLAYER_MISSING2_TEXT	已與切斷通訊。
SYS_NOTIFICATION_UNSTABLE_NETWORK_TEXT	由於您與對方的通訊環境不佳，可能無法順暢遊玩。\n您可以在「 設定」更改通訊模式。
SYS_NOTIFICATION_UNSTABLE_NETWORK2_TEXT	由於您與對方的通訊環境不佳，可能無法順暢遊玩。
SYS_NOTIFICATION_CONNECTED_CONTROLLER_NUM_1_TEXT	連接的控制器已變成1個。
SYS_NOTIFICATION_CONNECTED_CONTROLLER_NUM_2_TEXT	連接的控制器已變成2個。
SYS_NOTIFICATION_OPERATION_DENIED_TEXT	正在操作。
SYS_NOTIFICATION_OPERATION_DENIED2_TEXT	正在操作。
SYS_NOTIFICATION_DENIED_MOVE_OPERATION_TEXT	無法移動作品。\n必須將排序更改成「按喜愛順序」。
SYS_POPUP_GUIDE_PRO_CONTROLLER_SELECT	按鍵移動游標
SYS_POPUP_GUIDE_PRO_CONTROLLER_START	按鍵開始遊戲
SYS_POPUP_GUIDE_JOY_L_CONTROLLER_SELECT	 + 移動游標
SYS_POPUP_GUIDE_JOY_L_CONTROLLER_START	 + 開始遊戲
SYS_POPUP_GUIDE_JOY_R_CONTROLLER_SELECT	 + 移動游標
SYS_POPUP_GUIDE_JOY_R_CONTROLLER_START	 + 開始遊戲
SYS_POPUP_GUIDE_LARK_L_CONTROLLER_SELECT	按鍵移動游標
SYS_POPUP_GUIDE_LARK_L_CONTROLLER_START	按鍵開始遊戲
SYS_POPUP_GUIDE_LARK_R_CONTROLLER_SELECT	按鍵移動游標
SYS_POPUP_GUIDE_LARK_R_CONTROLLER_START	按鍵開始遊戲
SYS_POPUP_GUIDE_PRO_PAUSE_MENU	 + 中斷遊戲
SYS_POPUP_GUIDE_JOY_L_PAUSE_MENU	 + 中斷遊戲
SYS_POPUP_GUIDE_JOY_R_PAUSE_MENU	 + 中斷遊戲
SYS_POPUP_GUIDE_LARK_PAUSE_MENU	 + 中斷遊戲
SYS_POPUP_GUIDE_LARK_L_PAUSE_MENU	按鍵中斷遊戲
SYS_POPUP_GUIDE_LARK_R_PAUSE_MENU	按鍵中斷遊戲
SYS_POPUP_GUIDE_LUCIA_PAUSE_MENU	 + 中斷遊戲
SYS_POPUP_GUIDE_PRO_SWAP_PLAYERS	在中斷選單按鍵可更換1P/2P
SYS_POPUP_GUIDE_JOY_L_SWAP_PLAYERS	在中斷選單按鍵可更換1P/2P
SYS_POPUP_GUIDE_JOY_R_SWAP_PLAYERS	在中斷選單按鍵可更換1P/2P
SYS_POPUP_GUIDE_LARK_SWAP_PLAYERS	要更換1P/2P請到中斷選單。
SYS_POPUP_GUIDE_FINGER_CURSOR	為手掌游標，按為拍手
SYS_POPUP_GUIDE_LARK_SYSTEM_BUTTON_HOME	HOME選單按鍵
SYS_POPUP_GUIDE_LARK_SYSTEM_BUTTON_CAPTURE	拍攝按鍵
SYS_POPUP_GUIDE_LARK_R_SYSTEM_BUTTON_HOME	HOME選單按鍵
SYS_POPUP_GUIDE_LARK_L_SYSTEM_BUTTON_CAPTURE	拍攝按鍵
SYS_POPUP_GUIDE_LUCIA_SYSTEM_BUTTON_HOME	HOME選單按鍵
SYS_POPUP_GUIDE_LUCIA_SYSTEM_BUTTON_CAPTURE	拍攝按鍵
SYS_POPUP_GUIDE_PRO_REWIND	失誤也沒有關係。長按 + 就會倒回。\n可以在看中的地方重來。
SYS_POPUP_GUIDE_JOY_L_REWIND	失誤也沒有關係。長按 + 就會倒回。\n可以在看中的地方重來。
SYS_POPUP_GUIDE_JOY_R_REWIND	失誤也沒有關係。長按 + 就會倒回。\n可以在看中的地方重來。
SYS_POPUP_GUIDE_LARK_REWIND	失誤也沒有關係。長按 + 就會倒回。\n可以在看中的地方重來。
SYS_POPUP_GUIDE_LARK_L_REWIND	失誤也沒有關係。長按就會倒回。\n可以在看中的地方重來。
SYS_POPUP_GUIDE_LARK_R_REWIND	失誤也沒有關係。長按就會倒回。\n可以在看中的地方重來。
SYS_POPUP_GUIDE_LUCIA_REWIND	失誤也沒有關係。長按 + 就會倒回。\n可以在看中的地方重來。
SYS_HUD_GUIDE_PRO_INGAME_PAUSE_WITH_REWIND	 +   中斷選單（長按則倒回）
SYS_HUD_GUIDE_JOY_L_INGAME_PAUSE_WITH_REWIND	 +   中斷選單（長按則倒回）
SYS_HUD_GUIDE_JOY_R_INGAME_PAUSE_WITH_REWIND	 +   中斷選單（長按則倒回）
SYS_HUD_GUIDE_LARK_INGAME_PAUSE_WITH_REWIND	 +   中斷選單（長按則倒回）
SYS_HUD_GUIDE_LARK_L_INGAME_PAUSE_WITH_REWIND	  中斷選單（長按則倒回）
SYS_HUD_GUIDE_LARK_R_INGAME_PAUSE_WITH_REWIND	  中斷選單（長按則倒回）
SYS_HUD_GUIDE_LARK_LR_INGAME_PAUSE_WITH_REWIND	  中斷選單（長按則倒回）
SYS_HUD_GUIDE_LUCIA_INGAME_PAUSE_WITH_REWIND	 +   中斷選單（長按則倒回）
SYS_SORT_ORDER_CUSTOM	按喜愛順序
SYS_SORT_ORDER_RELEASE_DATE	按發售日順序
SYS_SORT_ORDER_TITLE_NAME	按作品名稱順序
SYS_SORT_ORDER_PUBLISHER	按發行商順序
SYS_SORT_ORDER_2PLAYER_GAMES	按2P同時遊玩順序
SYS_SORT_ORDER_DELIVERY_DATE	按發布順序
SYS_SORT_ORDER_DESC_TEXT	更改作品的排序方式
SYS_SORT_ORDER_NAME_CUSTOM	按喜愛順序
SYS_SORT_ORDER_NAME_ALPHABETICAL	按日語順序
SYS_SORT_ORDER_NAME_RELEASE_DATE	按發售順序
SYS_SORT_ORDER_NAME_RECENTLY_PLAYED	按遊玩先後順序
SYS_SORT_ORDER_NAME_PLAY_TIME	按遊玩長度順序
SYS_SORT_HEADING_PLAY_TIME	分鐘
SYS_SORT_HEADING_PLAY_TIME_2	不到1分鐘
SYS_SORT_HEADING_DATE_PLAYED_1	//
SYS_SORT_HEADING_DATE_PLAYED_2	/
SYS_USER_GUIDE_CONTROLLER_A	A
SYS_USER_GUIDE_CONTROLLER_B	B
SYS_USER_GUIDE_CONTROLLER_X	X
SYS_USER_GUIDE_CONTROLLER_Y	Y
SYS_USER_GUIDE_CONTROLLER_L	L
SYS_USER_GUIDE_CONTROLLER_R	R
SYS_USER_GUIDE_CONTROLLER_DPAD	十字鍵
SYS_USER_GUIDE_CONTROLLER_SELECT	SELECT
SYS_USER_GUIDE_CONTROLLER__START	START
SYS_USER_GUIDE_PRO_POINTER	手掌游標\n（按下即拍手）\n※限線上遊玩時
SYS_USER_GUIDE_JOY_L_COMBINATION	 +  SELECT     +  START
SYS_USER_GUIDE_JOY_R_COMBINATION	 +  SELECT     +  START
SYS_USER_GUIDE_LARK_COMBINATION	 +  中斷選單
SYS_USER_GUIDE_LUCIA_COMBINATION	 +  中斷選單
SYS_USER_GUIDE_PAUSE_MENU	中斷選單
SYS_USER_GUIDE_SYSTEM_HOME	 HOME選單
SYS_USER_GUIDE_SYSTEM_CAPTURE	 拍攝
SYS_USER_GUIDE_SYSTEM_CAPTURE2	拍攝 
SYS_USER_GUIDE_MICROPHONE	麥克風
SYS_USER_GUIDE_MICROPHONE_VOLUME	麥克風音量
SYS_USER_GUIDE_MICROPHONE_NOT_SUPPORTED	不能以此握持方式\n使用麥克風
META_TITLE_COMMENT_S_2017_j	瑪利歐以Dinosaur Land為舞台展開一場大冒險。\n斗篷瑪利歐及耀西首次登場。\n\n本作品於1990年發售，為Super Famicom中的一款動作遊戲。\n瑪利歐和路易吉為了救出被庫巴擄走的碧姬公主，\n將以Dinosaur Land為舞台展開一場冒險。\n遊戲中充滿各種精采絕倫的動作及多采多姿的角色，\n像是與值得信賴的好同伴耀西一起打倒敵人，\n或是穿上斗篷在天空翱翔等等。\n玩家會在機關及解謎要素變化萬千的關卡中過關。
META_TITLE_COMMENT_S_2023_j	耀西一行將為了拯救雙胞胎孩子而大奮戰。\n\n本作品於1995年發售，為Super Famicom中的一款動作遊戲。\n揹著孩子的耀西一行為了救出被庫巴王國魔法師卡美克所擄走的\n另一個雙胞胎孩子而踏上冒險之旅。\n在遊戲中要用蛋做出各種動作並活用直升機及鼬鼠戰車等「變身道具」，\n以通過6個世界。\n這款遊戲猶如繪本般具有手繪溫度的畫風也值得注意喔。
META_TITLE_COMMENT_S_2016_j	瑪利歐系列角色為奪得冠軍而激烈競爭。\n\n本作品於1992年發售，為Super Famicom中的一款動作競賽遊戲。\n這是瑪利歐系列角色以賽車來競賽及對戰的《瑪利歐賽車》系列第1作。\n這款遊戲以賽車道和泥巴路等場景作為關卡，\n玩家需從強項是加速或抓地力等\n特色各有不同的8位角色中選擇1位來挑戰比賽。\n此外，遊戲中也有讓對手打轉的香蕉皮或是\n讓自己的賽車變成無敵狀態的無敵星等道具。
META_TITLE_COMMENT_S_2024_j	在Super Famicom中登場的《薩爾達傳說》。\n使用各式各樣的動作和武器，挑戰充滿解謎要素的迷宮。\n\n本作品於1991年發售，為Super Famicom中的一款動作冒險遊戲。\n玩家要操縱主角林克在原野和迷宮中冒險，以打倒邪惡之王加農。\n劍的攻擊有迴旋斬和衝刺等多種攻擊方式。\n另外還有很多能在冒險途中獲得的道具，像是迴旋鏢、弓和炸彈等等。\n除了奔跑、游泳等基本動作之外，也能拿起物品投擲和拉，\n在適當的時機善用這些動作，解開隱藏在原野和迷宮中的謎題，\n就能讓故事發展下去。
META_TITLE_COMMENT_S_2018_j	新的紛爭因不明生命體密特羅德而引發。\n運用多種動作探索行星Zebes吧！\n\n本作品於1994年發售，為Super Famicom中的一款科幻動作冒險遊戲。\n身穿加強服的女戰士薩姆斯‧亞蘭曾經於其中奮戰的行星Zebes\n為本作舞台，為了被搶走的不明生命體「密特羅德」，\n薩姆斯將與宇宙海盜展開死戰。\n遊戲中在路上會發現各式各樣的道具，\n裝備這些道具就能擴大行動範圍和攻擊手段。
META_TITLE_COMMENT_S_2011_j	在銀河自由自在奔馳的科幻3D射擊遊戲。\n\n本作品於1993年發售，為Super Famicom中的一款射擊遊戲。\n駕駛戰鬥機艾英的主角火狐是一名年輕的隊長。\n他將與同伴法爾科、派比和史利比他們攜手出擊，\n運用快速反轉、側滾翻和逆噴射等各種操作技巧，\n以擊碎邪惡科學家安德羅斯的野心。\n這款遊戲的特色是在以多邊形繪製的3D空間場景中，\n透過流暢的動作感受飛行的真實感。
META_TITLE_COMMENT_S_2005_j	駕駛浮遊車防範重重陷阱，奪得大獎賽冠軍。\n\n本作品於1990年發售，為Super Famicom中的一款競賽遊戲。\n玩家要藉由浮遊車跑遍9個行星都市的15條賽道。\n車子有各具特色的4種類可選，請防範碰到會受傷的光束護欄\n或引發打滑的特殊舖裝路面等陷阱。以贏得大獎賽冠軍。
META_TITLE_COMMENT_S_2012_j	讓人腎上腺素爆炸的瘋狂3D駕駛遊戲。\n\n本作品於1994年發售，為Super Famicom中的一款3D駕駛遊戲。\n遊戲的一大特色就是擬真的操控感覺，\n這是基於汽車工程學刻劃入微而得以呈現。\n玩家甚至可能會玩到身體跟著大搖大晃也說不定。\n車種有歡樂的3種供玩家選擇，獎勵關卡則能操控美國貨櫃車。\n藉由三度空間設計而充滿臨場感的超立體賽道也值得玩家攻略。\n還請拿出毅力和決心來挑戰。
META_TITLE_COMMENT_S_2009_j	在天空舞台中挑戰各式各樣的空中運動。\n\n本作品於1990年發售，為Super Famicom中的一款空中運動模擬遊戲。\n玩家將成為空中運動學校「Flight Club」的學生，\n挑戰各式各樣的科目。\n遊戲中收錄了空中運動特有的種目，例如駕駛Light Plane\n並順利地著陸，或是操控Rocketbelt穿越空中的圓環等等。\n請不時查看標有目的地的雷達和燃料狀況並通過課程。
META_TITLE_COMMENT_S_2008_j	卡比展開一場拯救波普之星的冒險！\n和同伴同心協力，一起打倒「邪惡的雲」吧！\n\n本作品於1998年發售，為Super Famicom中的一款動作遊戲。\n為了趕走襲擊噗噗噗之國的「邪惡的雲」，卡比及蠱依踏上冒險之旅。\n本作仍保留了將敵人吸入吞下後就能使用「石塊」或「冰凍」等的複製能力。\n好好加以活用，和強敵交手時就能不落下風。
META_TITLE_COMMENT_S_2007_j	大家熟知的卡比變成圓球橫衝直撞！\n用超級射擊把敵人變成星星吧！！\n\n本作品於1994年發售，為Super Famicom中的一款動作遊戲。\n帝帝帝大王獨自霸占了噗噗噗之國星光閃耀的夜空。\n失去光輝的天空黑壓壓一片！\n為了再次恢復噗噗噗之國美麗的夜空，\n卡比朝著帝帝帝大王居住的城堡前進。\n將變成粉紅色圓球的卡比射擊出去，\n在關卡中自由自在盡情滾動吧。
META_TITLE_COMMENT_S_2015_j	動作遊戲《魔界村》系列第3彈。\n運用多種武器和二段跳救出公主。\n\n本作品於1991年發售，為Super Famicom中的一款動作遊戲。\n是遊戲難易度高，但總讓人想要不斷嘗試的\n動作遊戲《魔界村》系列第3彈。\n遊戲主角是騎士亞瑟，他要運用多種武器和新動作二段跳，\n挺身面對魔物以救出被擄走的公主。\n遊戲中的各個關卡呈現了恐怖又美麗的魔界，\n有著會變化的地形和淹沒整個畫面的大海嘯等等表現。
META_TITLE_COMMENT_S_2004_j	可怕……傳說中的惡魔甦醒了。\n\n本作品於1994年發售，為Super Famicom中的一款動作角色扮演遊戲。\n過去為了6個具備力量的Crests曾引起「Crests戰爭」。\n「紅惡魔」終結了那場無止無境的戰爭，卻遭到卑鄙手段封印，\n使得魔界從此由那竊占的獨裁者所統治。\n過了1000年的時光，「紅惡魔」Firebrand終於甦醒，\n並開始解放其力量。\n遊戲中一旦取得散落世界各地的「Crests」就可以變身。\n魔力和特技會因應不同的形態而改變，\n請多多熟練，並搭配飄浮空中和貼住牆壁的能力運用。
META_TITLE_COMMENT_S_2021_j	採3D視點遊玩，充滿臨場感的足球遊戲。\n\n本作品於1991年發售，為Super Famicom中的一款運動遊戲。\n這款足球遊戲的特徵是從球門後方取視角的3D視點，\n有球員各具特色的16支基本隊伍和8種陣形供選擇。\n能遊玩的模式則有要接連贏過各世界強隊Tournament，\n以及只比一場的Exhibition。\n而除了理所當然的兩人對戰，也可以合作玩Tournament。
META_TITLE_COMMENT_S_2020_j	老牌動作益智遊戲的第二代帶著新要素登場！\n\n本作品於1995年發售，為Super Famicom中的一款益智遊戲。\n主角亞魯魯為了打敗一心想要難倒亞魯魯的撒旦，\n便進入了那撒旦坐陣於內的塔中。\n闖塔過程中將與性格各具特色的角色對戰，以抵達撒旦所在的塔頂。\n眾所熟悉的「抵消」「快速翻轉」「全消除」「NEXT氣泡」就出自本作，\n這些要素將在各種模式和規則中讓魔法氣泡越玩越熱烈。
META_TITLE_COMMENT_S_2014_j	操作簡單，越玩就會越有意思的\n《ファミリーテニス》在Super Famicom登場。\n\n本作品於1993年發售，為Super Famicom中的一款運動遊戲。\n操作方式單純，A鍵為強揮拍，B鍵為弱揮拍，X鍵為高吊球，\n但同時又能藉此擊出豐富的球種，輕輕鬆鬆便可體會到網球深奧的攻防。\n球場除了基本的3種外，還準備了5種帶有日本各地特色的特別球場，\n從中將能充分感受到觀光旅遊的氣氛。\n遊戲中的模式分別是可以任意選擇球員和球場對戰的表演賽模式，\n和一路在5場大賽中過關斬將的淘汰賽模式。
META_TITLE_COMMENT_S_2003_j	白龍族少年挺身面對種族宿怨引起的戰爭。\n\n本作品於1993年發售，為Super Famicom中的一款角色扮演遊戲。\n數千年前，白龍族和黑龍族曾為了邪惡女神的力量而發生激戰。\n白龍族在大戰後封印了本身強大的力量以作為警惕，\n世界從此度過一段和平時光，直到黑龍族再次發動侵略。\n白龍族少年Ryu為了尋找被擄走的姊姊Sara而離鄉背井。\n旅程中會成為同伴的角色各自具備了奇特的特技或特殊能力。\n請在各個場面嘗試那代表了各角色特色所在的能力。
META_TITLE_COMMENT_S_2002_j	5個角色火爆出擊，用豐富的攻擊招式掃蕩敵人的格鬥動作遊戲。\n\n本作品於1992年發售，為Super Famicom中的一款動作遊戲。\n主角ノートン和ビルド為救出失蹤的同伴而前往強敵嚴陣以待的人工島。\n遊戲剛開始只有兩個角色能使用，但隨著故事發展，\n將可以使用5個類型各異的角色，他們有的攻擊力強，有的身輕如燕。\n玩家要善用能大範圍攻擊的必殺技、有擊倒性能的衝刺攻擊、\n倒地狀態時的追打攻擊等動作，一路過關斬將通過關卡。\n雙打時有合作、對戰、競時這3種模式可以遊玩。
META_TITLE_COMMENT_S_2013_j	以特殊機動戰鬥機「XA-1」阻止AGYMA侵略地球！\n\n本作品於1991年發售，為Super Famicom中的一款射擊遊戲。\n地球收到了神秘組織「AGYMA」發出的攻擊預告，\n於是緊急出動地球統合軍的特殊機動戰鬥機「XA-1」。\n才出廠沒多久的XA-1就此隻身闖入敵營。\nXA-1打倒敵人時累積的分數就像角色扮演遊戲的經驗值一樣，\n到達特定值就會升級，各武器的攻擊力在升級後會變強。\n武器有八種，諸如火神炮、雷射、追蹤飛彈等等。\n玩家可以用擅長的武器作戰，或是依據關卡選擇合適武器，\n玩法組合豐富多變。\n座機身邊搭配了會一起攻擊的「子機」，玩家隨時可以切換陣形，\n隨時視敵人數量和武器而切換陣形就能有利於戰局發展。
META_TITLE_COMMENT_S_2006_j	突破高山、峽谷、洞窟等難關，奪回被搶走的頭冠！\n\n本作品於1994年發售，為Super Famicom中的一款動作遊戲。\n由於村中寶貴的頭冠被Gork搶走，Joe和Mac帶著棍棒\n展開了奪回頭冠的旅程。\n過程中要運用衝刺、跳躍、攻擊等動作打倒敵人，\n並收集7顆Rainbow Stone。此外，玩家可以用存來的錢\n改建房子或送花束給女生並結婚也是本作引人入勝之處。
META_TITLE_COMMENT_S_2031_j	傭兵游擊隊「星際火狐」在潛伏多時後終於出擊了！\n\n本作品為Super Famicom中的一款射擊遊戲。\n這款夢幻的系列第2作描寫了傭兵游擊隊「星際火狐」\n挺身對抗企圖征服萊拉特星系的安德羅斯皇帝的戰役。\n遊戲中除了有大家熟知的「火狐」、「法爾科」、「派比」、「史利比」4人外，\n還追加了「Miyu」及「Fay」兩位新成員。這6位成員將共同對抗安德羅斯皇帝。\n遊戲中滿載了繼承給後來《星際火狐》系列的新要素，\n諸如原來採用往前飛的「3D捲軸」，在本作變成以\n能夠360自由飛行和移動的「全方位模式」為主，\n還有艾英能變形成「步行形態」等等。
META_TITLE_COMMENT_S_2029_j	協助卡比的幫手登場！\n可享受6個不同遊戲模式的樂趣。\n\n本作品於1996年發售，為Super Famicom中的一款動作遊戲。\n其中一共有6個不同的遊戲模式，可享受各有不同的冒險樂趣。\n擁有各種能力的幫手，會作為卡比的同伴登場。\n請與幫手同心協力過關。\n另外也有抓準時機按下按鍵或是\n只要快速按按鍵遊玩的操作簡單小遊戲。
META_TITLE_COMMENT_S_2010_j	《ツインビー》系列的第6作。\n世界觀新潮又可愛的縱向捲軸射擊遊戲。\n\n本作品於1993年發售，為Super Famicom中的一款射擊遊戲。\nTwinBee他們從少女Madoka的口中得知少女的祖父Dr. Mardock\n變成了壞人後，為了讓他復原而出動。\n本作沒有剩餘機數的概念，在生命量表耗盡之前，\n受到敵人或子彈擊中都不會墜落。\n從雲中會出現鈴鐺，攻擊後會變顏色，不同顏色的鈴鐺各有其效果。\n玩雙打時，會共用生命，還可以做出將對方丟出去這種特殊的玩法。
META_TITLE_COMMENT_S_2025_j	《ブレス オブ ファイア》系列第2彈。\n得知自身命運的少年Ryu與各富特色的同伴將共創故事。\n\n本作品於1994年發售，為Super Famicom中的一款角色扮演遊戲。\n因不幸際遇而孑然一身的少年Ryu，\n為了探究其原因而與相同遭遇的孤兒Bow一起離開村子冒險旅行。\n他們在過程中將認識富有個性的同伴，例如長有翅膀的Nina、\n身體龐大且負有硬殼的Rand、女性虎人的Katt等等。\n遊戲中還有能隨個人喜好發展市鎮的「TownShip」和\n能明白其他人和同伴的情感的「Dragon Tear」等系統。
META_TITLE_COMMENT_S_2034_j	湊合消除色彩各異的面板，並形成連鎖的益智遊戲。\n\n本作品於1995年發售，為Super Famicom中的一款動作益智遊戲。\n玩法是對調左右相鄰的面板，將相同面板在縱向或横向\n湊成3個以上來消除。諸多技巧中，最為重要的就是「動態連鎖」，\n也就是在面板消失期間繼續操作面板連鎖消除。\n若能善用這招，賺分時就能獲得高分，\n在VS模式則能送出大型的妨礙面板。
META_TITLE_COMMENT_S_2019_j	以世界強敵為對手，3分鐘一決勝負。\n勝負的關鍵掌握於強勁的Knock Out Punch。\n\n本作品是1998年透過Super Famicom的\n卡帶覆寫系統「Nintendo Power」所發售的一款運動遊戲。\n拳擊手主角將向世界各國個性豐富的強敵挑戰。\n只要簡單的操作就能做出出拳、防禦、閃躲等真正的拳擊動作，\n也可以擊出威力強大的Knock Out Punch。\n請配合對手的動作和特徵活用這些動作，\n以獲得最後的冠軍。
META_TITLE_COMMENT_S_2055_j	森喜剛和狄狄剛合力取回被偷走的香蕉！\n\n本作品於1994年發售，為Super Famicom中的一款動作遊戲。\n森喜剛高大而孔武有力，狄狄剛則是嬌小而行動矯捷。\n他們將以無間的合作精采表現，在過程中以各種動作打倒敵人，\n或是克服機關前進。玩家操作的是在前面的角色，\n須因應狀況交換前面的角色抵達終點。木箱中會有友好的動物朋友，\n讓他們用各自的特技來幫忙吧。
META_TITLE_COMMENT_S_2147_j	真‧女神轉生系列第一作。你選擇的是規律，抑或混沌……\n與仲魔共同奮戰，見證自己的抉擇結果。\n\n本作品於1992年發售，為Super Famicom中的一款角色扮演遊戲。\n過程中要與惡魔交涉，招攬為仲魔，\n並以惡魔合體系統創造更強的仲魔，以闖過藏有強敵的迷宮。\n根據主角的行動，將會決定會屬於以規律為重的「LAW」，\n或是以混沌為重的「CHAOS」，\n又或者是不屬任何一邊的「NEUTRAL」這三種屬性之一。\n主角的屬性變化將大幅影響故事的結局。
META_TITLE_COMMENT_S_2033_j	夢寐以求的４大瑪利歐合集。\n\n本作品於1993年發售，為Super Famicom中的一款動作遊戲。\n還請品味畫面、聲音的品質比起Family Computer時更加提升的\n《超級瑪利歐兄弟》《超級瑪利歐兄弟2》《超級瑪利歐兄弟3》\n《超級瑪利歐兄弟USA》。\n另外，在《超級瑪利歐兄弟3》中，可以獨自進行2人遊玩的「對戰遊戲」。
META_TITLE_COMMENT_S_2060_j	勇敢的Dixie Kong和狄狄剛這一對將出外冒險，\n尋找被擄走的森喜剛。\n\n本作品於1995年發售，為Super Famicom中的一款動作遊戲。\nDixie Kong和狄狄剛為了救出遭到庫魯魯船長擄走的森喜剛，\n展開了冒險的旅程。雖然他們兩個身材比森喜剛嬌小，不夠有力，\n可是運用團隊合作方式就可以拓展行動範圍，\n到達無法獨自前往的地點或取得道具。\n為老玩家熟悉的動物朋友則有新同伴加入，並以獨特的特技來協助冒險。
META_TITLE_COMMENT_S_2027_j	訂立戰略指揮單位進軍，引導馬爾斯軍得勝。\n\n本作品於1994年發售，為Super Famicom中的一款角色扮演模擬遊戲。\n玩家要指揮主角馬爾斯率領的軍隊，體驗阿卡奈亞陸地發生的兩場戰亂。\n遊戲中會有許多充滿個性的角色登場，其中也有人會加入助陣。\n但是被敵人打倒的同伴，基本上再也無法復活，必須小心。
META_TITLE_COMMENT_S_2022_j	藉由Super Famicom實現的真實遊玩感！\n全球頂尖球員等著您來挑戰。\n\n本作品於1991年發售，為Super Famicom中的一款運動遊戲。\n特色各有不同的20名世界頂尖球員將會在\nSuper Famicom首款網球遊戲的本作展開熱烈的賽局。\n為贏得勝利，就要熟悉球員位置、按鍵、不同時機下的多種擊球方式。\n遊戲中除了可任意選擇球員和球場對戰的單打和雙打模式，\n還有要轉戰全球各地的比賽，角逐積分的巡迴模式。
META_TITLE_COMMENT_S_2049_j	在科幻西部片的世界中盡情射擊的超震撼射擊動作遊戲！\n\n本作品於1994年發售，為Super Famicom中的一款動作遊戲。\n為了打倒海盜Kid，穿梭宇宙賺取獎金的Clint\n和一心報仇的大地主之女Annie將在行星上發威。\n按住Y鍵可以連續開槍，而這時十字鍵是移動準星，不能移動玩家。\n除了開槍，還能抛繩索停住敵人的動作、毆打靠近的敵人等特殊攻擊，\n以及二段跳和翻滾迴避等豐富的動作，還請善加活用，\n以逮住海盜Kid。
META_TITLE_COMMENT_S_2061_j	Dixie Kong和Kiddy Kong為了尋找遲遲不回的森喜剛他們，\n將在Northern Kremisphere展開大冒險！\n\n本作品於1996年發售，為Super Famicom中的一款動作遊戲。\n狄狄剛留下了「我和森喜剛去島嶼探險，明天回來」這段話出門，\n但過了幾天，他們都沒有回來，Dixie Kong因為擔心，\n就帶著小嬰兒Kiddy Kong前往神秘的Northern Kremisphere。\nKiddy Kong雖然還是個走路搖晃的小嬰兒，但身材高大且力氣十足，\n表現不輸給大人。Dixie Kong身輕如燕，Kiddy Kong力量強大，\n特色各不相同，必須臨機應變地運用。\n在Northern Kremisphere上若救到被關在許多地點的Banana Bird，\n會得到好處，還請務必找出所有的Banana Bird。
META_TITLE_COMMENT_S_2142_j	將受困者救出危險災難現場的救難動作遊戲！\n\n本作品於1994年發售，為Super Famicom中的一款救難動作遊戲。\n玩家要操作消防員主角，拯救來不及逃出災難現場的受困者。\n通過任務的方式是要在各任務的規定時間內救出規定人數並逃出房子。\n要順利通過關卡，就得在任務開始前的會議中先掌握房子的構造，\n找出前往受困者所在地點的最短路線，並將滅火時間設法縮到最短。\n和同伴交談可以補給或交換用來開路的道具。\n要想快速救人，要訣就是使用道具，可別捨不得用了。
META_TITLE_COMMENT_S_2026_j	運用國夫那超乎常軌的招式連戰連勝，\n向世界第一的躲避球隊邁進！\n\n本作品於1993年發售，為Super Famicom中的一款運動遊戲。\n玩家要與各國特色各不相同的球隊競賽，以成為世界第一的躲避球隊。\n遊戲中除了有豐富的跳躍和傳球可用，還設計了威力十足的殺球。\n各個關卡內藏有特殊的機關，會讓比賽發展出乎預料。\n由於隊伍可藉由購買道具或培育球員來強化，\n還請組成一支理想的球隊和對手球隊一較高下。
META_TITLE_COMMENT_S_2032_j	「へべ」等角色大混戰，贏家會是誰！？\n\n本作品於1994年發售，為Super Famicom中的一款動作遊戲。\n舞台上會有四名角色混戰，留到最後的就是贏家。\n以「へべ」為首的各角色除了一般攻擊，還有兩招能藉由獨特指令使出，\n性質各有特色的「特殊攻擊」。\n請使用「道具」和舞台上的「陷阱」，在激烈對戰中稱霸。
META_TITLE_COMMENT_S_2044_j	依據行列上的提示數字填方格畫出圖案。\n\n本作品於1995年發售，為Super Famicom中的一款益智遊戲。\n方格左邊和上邊會有提示數字，玩家要以此畫出隱藏的圖案。\n遊戲中還設有以兩人遊玩方式解決問題，或困難問題眾多的\nWario's Super Picross等內容，十分耐玩。
META_TITLE_COMMENT_S_2145_j	不要過來……不要找我……\n\n本作品於1992年發售，為Super Famicom中的一款動作遊戲。\nD-Movie是虛擬空間的世界，Sayaka進入這世界後再也沒回現實世界。\n主角Ryo和Maria為了救他，就此進入恐怖的\n幻想軟體《Legend of the Fallen Capital》中。\n道具（蛋白質）的效果因顏色而異，攻擊方式會因此變成\n近距離型和遠距離型，還具有強化攻擊力等等的效果。\n遊戲中共有6個Track，請依據狀況善加運用來過關。
META_TITLE_COMMENT_S_2148_j	真‧女神轉生系列第二作。\n新主角的新選擇將決定世界的走向。\n\n本作品於1994年發售，為Super Famicom中的一款角色扮演遊戲。\n本作是《真‧女神轉生》的續作，以曾經叫作東京的城市\nTOKYOミレニアム為舞台。過程中不只要和惡魔戰鬥，時而須與之交涉，\n招攬成為仲魔，以挑戰強敵。結局會因為主角的行動及抉擇而\n大幅改變的特色依舊，還新增了以惡魔合體繼承魔法、\n在虛擬空間訓練以賺取經驗值的「ヴァーチャルバトラー」等各種要素。
META_TITLE_COMMENT_S_2028_j	《Fire Emblem》系列第四作。\n故事發展縱貫親子兩個世代。\n\n本作品於1996年發售，為Super Famicom中的一款角色扮演模擬遊戲。\n主角Seliph公國的Sigurd要和同伴一起克服接踵而來的戰役。\n玩家將能欣賞到縱貫親子兩個世代的故事，登場角色有時還會陷入情網。\n生下的孩子將可能繼承到父母的能力。
META_TITLE_COMMENT_S_2139_j	現身世紀末的最惡最強怪人展開激烈對戰！！\n\n本作品於1992年發售，為Super Famicom中的一款格鬥動作遊戲。\n7人組成的Doom Squad作惡多端，無法坐視的天使令其中6人改過向善。\n原本同伙的6人在改過向善後，便挺身面對還持續對抗的剩餘1人。\n在單人模式中，對戰勝利後會得到獎勵分數，可以用來培育角色，\n而該角色也可以在「VS MODE」中使用。
META_TITLE_COMMENT_S_2151_j	規則簡單和角色可愛受到歡迎的《マジカルドロップ》系列第2彈。\n\n本作品於1996年發售，為Super Famicom中的一款動作益智遊戲。\n畫面上方有球往下降，要拿球投出，同色球直向排列3個以上就可消除。\n遊戲中有四種模式可以玩，例如玩完時會以段位判定玩家實力的\n「Endless Mode」，還有要從十個角色選出一人，以對戰方式勝出的\n「Story Mode」等等。
META_TITLE_COMMENT_S_2169_j	Joe和Mac一同冒險的《戦え原始人》系列第1彈。\n他們有辦法救回被擄走的女孩嗎？\n\n本作品於1991年發售，為Super Famicom中的一款動作遊戲。\n由於村子裡的女孩被被外族擄走，村長等人選出了Joe和Mac去救人，\n於是力量傲人的兩人就帶著棍棒出發了。\n冒險過程中，要運用跳躍、衝刺和翻滾攻擊等動作前進。\n身上有多種武器時，可以用SELECT鍵更換，以應付不同的狀況。\n過關時將有獎勵在等著玩家喔。
META_TITLE_SUBTITLE_S_2016_j_sp1	全賽道款待版本
META_TITLE_COMMENT_S_2016_j_sp1	～彩虹之路和150cc都有～\n\n本作品是所有盃和賽道都能遊玩的《超級瑪利歐賽車》特別版。\n也有150cc能選擇，是應有盡有的完全套餐。\n不過玩家喜歡玩什麼就請玩什麼，不用像套餐一樣有固定的用餐順序喔。
META_TITLE_COMMENT_S_2149_j	一段關於學生身陷魔界的故事。\n他們將和搭檔及仲魔一同設法返回現實世界。\n\n本作品於1994年發售，為Super Famicom中的一款角色扮演遊戲。\n身為學生的主角，突然身陷魔界，為了離開魔界，他將闖蕩各種世界。\n故事發展會隨著初期以「ユミ」「レイコ」「チャーリー」之中的誰\n為搭檔而有大幅變化。遊戲中搭配了「ガーディアンシステム」，\n被打倒時會出現惡魔來復活是本作的特色。\n招攬敵人成為仲魔來應戰，或將仲魔合體成為其他仲魔，\n這類系列作的慣例要素也保留在本作中。
META_TITLE_COMMENT_S_2146_j	心中各懷目標的四名戰士將挑戰巨大的死亡高塔！\n\n本作品於1993年發售，為Super Famicom中的一款格鬥動作遊戲。\n遊戲中有四名主角：Syoh、Zazi、Kotono、Vortz，\n要從中選出一人，去挑戰格鬥神Jade。\n在Story mode中，必殺技會在每打倒特定數量的敵人後升級，\n並變成更強的招式，還請與防禦搭配運用，看準機會施展必殺技。\n即時重播會精采重現終結場景，熱絡遊玩氣氛。
META_TITLE_COMMENT_S_2156_j	引爆炸彈！在時限內過關！\n\n本作品於1990年發售，為Super Famicom中的一款動作益智遊戲。\n過關方式是利用各種機關，在限制時間內引爆地圖上的炸彈和地雷。\n必須注意的是，爆炸範圍會依據炸彈和地雷的大小而異，以免遭到波及。\n遊戲中按下SELECT鍵可以換成上方俯瞰的2D模式或從斜向看的3D模式，\n可以採用適合自己的模式，努力通過所有關卡。
META_TITLE_COMMENT_S_2051_j	不管你是大人小孩或大姐姐。\n帶著可靠的伙伴一起環遊世界展開大冒險！\n\n本作品於1994年發售，為Super Famicom中的一款角色扮演遊戲。\n遊戲的舞台是199X年的地球。住在綠意盎然的小鎮Onett的少年奈斯，\n由於去看了墜落在山上的隕石，讓他展開環遊世界的冒險。\n他在過程中將邂逅一起參與冒險的可靠同伴，還有「Mr. Saturn」等\n風格獨特的角色，並且收集散落在世界各地的8段旋律。
META_TITLE_SUBTITLE_S_2018_j_sp1	薩姆斯‧亞蘭最終形態
META_TITLE_COMMENT_S_2018_j_sp1	～集齊所有裝備～\n\n本作品是已取得所有強化道具，並強化了武器和加強服，\n主角薩姆斯‧亞蘭處在最強狀態下的《超級密特羅德》特別版。\n距離去打倒位在要塞中心的Mother Brain就差一步了。\n本遊戲的結局會依據通過遊戲所花費的時間而有小小改變（共3種）。\n以此版本的狀態立刻去過關，就能拜見脫下加強服的薩姆斯身影。
META_TITLE_COMMENT_S_2037_j	溫馨生活模擬遊戲\n\n本作品於1996年發售，為Super Famicom中的一款生活模擬遊戲。\n故事的舞台位在Flower Bud Village，男主角繼承了祖父的牧場，\n並要在三年內妥善重建。除了栽種農作物、養殖動物、擴建房舍等\n發展牧場的工作外，還可以和村民交流，與結婚人選的女孩談戀愛結婚。
META_TITLE_SUBTITLE_S_2019_j_sp1	冠軍款式
META_TITLE_COMMENT_S_2019_j_sp1	～拳力十足的16名競爭對手大匯集～\n\n本作品是《スーパーパンチアウト!!》特別版，可以挑戰所有輪迴賽和\n所有比賽對手。除了「MINOR CIRCUIT」、「MAJOR CIRCUIT」、\n「WORLD CIRCUIT」，也能挑戰以上輪迴賽都全勝稱霸才能選的\n「SPECIAL CIRCUIT」。在「SPECIAL CIRCUIT」出場的四名拳擊手，\n分別是Narcis Prince、Hoy Quarlow、Rick Bruiser、Nick Bruiser。\n各位或許先在「TIME ATTACK MODE」練習再去挑戰比較好。另外，\n當年的開發人員打出的「SPECIAL CIRCUIT」最高分據說是583,550。
META_TITLE_SUBTITLE_S_2017_j_sp1	別有不同的形象改變版本
META_TITLE_COMMENT_S_2017_j_sp1	～招待你前往特別關之後世界～\n\n本作品是《超級瑪利歐世界》特別版，可以在不同以往的氣氛下遊玩。\n一開始就在通過特別關後抵達的，氣氛迥異的Dinosaur Land。\n不妨在這新鮮的感覺下再冒險一次如何呢？
exploded_strings
SYS_DIALOG_GENERIC_BUTTON1	[GENERIC_DIALOG_BUTTON1]
SYS_DIALOG_GENERIC_BUTTON2	[GENERIC_DIALOG_BUTTON2]
SYS_DIALOG_GENERIC_BUTTON3	[GENERIC_DIALOG_BUTTON3]
SYS_DIALOG_EXCHANGE_PLAYER_1P_TEXT	已經更換1P與2P。\n您成為了1P。\n選單將由[HOST_NAME]繼續操作。
SYS_DIALOG_EXCHANGE_PLAYER_2P_TEXT	已經更換1P與2P。\n您成為了2P。\n選單將由[HOST_NAME]繼續操作。
SYS_DIALOG_ONLINE_CREATE_SESSION_WITH_PASSWORD	[IMG_LOCK] 有暗號
SYS_DIALOG_ONLINE_WAITING_FOR_GUEST_TEXT	正在與[GUEST_NAME]會合。
SYS_DIALOG_ONLINE_WAITING_FOR_HOST_TEXT	正在與[HOST_NAME]會合。\n（不會更改您的儲存資料）
SYS_DIALOG_ONLINE_ESTABLISHED_HOST_TEXT	[GUEST_NAME]過來遊玩了。\n選單將由[HOST_NAME]操作。\n通訊品質依據您與對方的通訊環境而定。
SYS_DIALOG_ONLINE_ESTABLISHED_GUEST_TEXT	您來到[HOST_NAME]的地方遊玩。\n選單將由[HOST_NAME]操作。\n通訊品質依據您與對方的通訊環境而定。
SYS_DIALOG_DURING_GUEST_OPERATION_TEXT	[GUEST_NAME]正在操作。
SYS_DIALOG_DURING_HOST_OPERATION_TEXT	[HOST_NAME]正在操作。
SYS_DIALOG_ONLINE_PAUSE_ON_DISCONNECT_TEXT	已經與[GUEST_NAME]切斷通訊。\n遊戲將無法繼續。\n只允許隨時隨地儲存。
SYS_HUD_GUIDE_PRO_CONFIRM	[IMG_BUTTON_A]  確定
SYS_HUD_GUIDE_PRO_BACK	[IMG_BUTTON_B]  返回
SYS_HUD_GUIDE_PRO_DETAILS	[IMG_BUTTON_X]  詳情
SYS_HUD_GUIDE_PRO_MOVE	[IMG_BUTTON_Y]  移動
SYS_HUD_GUIDE_PRO_MOVE2	[IMG_BUTTON_Y]  移動（長按則排序）
SYS_HUD_GUIDE_PRO_SORT	[IMG_BUTTON_Y]  長按則排序
SYS_HUD_GUIDE_PRO_PLAY	[IMG_BUTTON_A]  開始
SYS_HUD_GUIDE_PRO_INVITE	[IMG_BUTTON_PLUS]  邀請朋友
SYS_HUD_GUIDE_PRO_Invitation	[IMG_BUTTON_PLUS]  邀請朋友
SYS_HUD_GUIDE_PRO_GUIDE	[IMG_BUTTON_X]  操作指南
SYS_HUD_GUIDE_PRO_EXCHANGE	[IMG_BUTTON_Y]  更換1P/2P
SYS_HUD_GUIDE_PRO_VOICE_CHAT	[IMG_BUTTON_X]  如何語音聊天？
SYS_HUD_GUIDE_PRO_PROMOTION	[IMG_BUTTON_X]  關於專用控制器
SYS_HUD_GUIDE_PRO_INGAME_PAUSE	[IMG_BUTTON_ZL] + [IMG_BUTTON_ZR]  中斷選單
SYS_HUD_GUIDE_PRO_INGAME_START	[IMG_BUTTON_PLUS]  START鍵
SYS_HUD_GUIDE_PRO_INGAME_SELECT	[IMG_BUTTON_MINUS]  SELECT鍵
SYS_HUD_GUIDE_PRO_INGAME_QUIT_ONLINE	[IMG_BUTTON_ZL] + [IMG_BUTTON_ZR]  退出線上遊玩
SYS_HUD_GUIDE_PRO_DETAILES_NEXT	[IMG_BUTTON_A]  繼續
SYS_HUD_GUIDE_PRO_COMMIT	[IMG_BUTTON_Y]  確定
SYS_HUD_GUIDE_PRO_CANCEL	[IMG_BUTTON_B]  復原
SYS_HUD_GUIDE_PRO_NETPLAY_OPTIONAL_MODE	[IMG_BUTTON_Y]  開啟低延遲通訊模式
SYS_HUD_GUIDE_PRO_NETPLAY_PRIMARY_MODE	[IMG_BUTTON_Y]  關閉低延遲通訊模式
SYS_HUD_GUIDE_JOY_L_CONFIRM	[IMG_BUTTON_CLOVER_R]  確定
SYS_HUD_GUIDE_JOY_R_CONFIRM	[IMG_BUTTON_CLOVER_R]  確定
SYS_HUD_GUIDE_JOY_L_BACK	[IMG_BUTTON_CLOVER_D]  返回
SYS_HUD_GUIDE_JOY_R_BACK	[IMG_BUTTON_CLOVER_D]  返回
SYS_HUD_GUIDE_JOY_L_DETAILS	[IMG_BUTTON_CLOVER_U]  詳情
SYS_HUD_GUIDE_JOY_R_DETAILS	[IMG_BUTTON_CLOVER_U]  詳情
SYS_HUD_GUIDE_JOY_L_MOVE	[IMG_BUTTON_CLOVER_L]  移動
SYS_HUD_GUIDE_JOY_L_MOVE2	[IMG_BUTTON_CLOVER_L]  移動（長按則排序）
SYS_HUD_GUIDE_JOY_L_SORT	[IMG_BUTTON_CLOVER_L]  長按則排序
SYS_HUD_GUIDE_JOY_R_MOVE	[IMG_BUTTON_CLOVER_L]  移動
SYS_HUD_GUIDE_JOY_R_MOVE2	[IMG_BUTTON_CLOVER_L]  移動（長按則排序）
SYS_HUD_GUIDE_JOY_R_SORT	[IMG_BUTTON_CLOVER_L]  長按則排序
SYS_HUD_GUIDE_JOY_L_PLAY	[IMG_BUTTON_CLOVER_R]  開始
SYS_HUD_GUIDE_JOY_R_PLAY	[IMG_BUTTON_CLOVER_R]  開始
SYS_HUD_GUIDE_JOY_L_GUIDE	[IMG_BUTTON_CLOVER_U]  操作指南
SYS_HUD_GUIDE_JOY_R_GUIDE	[IMG_BUTTON_CLOVER_U]  操作指南
SYS_HUD_GUIDE_JOY_L_EXCHANGE	[IMG_BUTTON_CLOVER_L]  更換1P/2P
SYS_HUD_GUIDE_JOY_R_EXCHANGE	[IMG_BUTTON_CLOVER_L]  更換1P/2P
SYS_HUD_GUIDE_JOY_L_VOICE_CHAT	[IMG_BUTTON_CLOVER_U]  如何進行語音聊天？
SYS_HUD_GUIDE_JOY_R_VOICE_CHAT	[IMG_BUTTON_CLOVER_U]  如何進行語音聊天？
SYS_HUD_GUIDE_JOY_L_PROMOTION	[IMG_BUTTON_CLOVER_U]  關於專用控制器
SYS_HUD_GUIDE_JOY_R_PROMOTION	[IMG_BUTTON_CLOVER_U]  關於專用控制器
SYS_HUD_GUIDE_JOY_L_INGAME_PAUSE	[IMG_BUTTON_MINUS] + [IMG_BUTTON_ZL]  中斷選單
SYS_HUD_GUIDE_JOY_R_INGAME_PAUSE	[IMG_BUTTON_PLUS] + [IMG_BUTTON_ZR]  中斷選單
SYS_HUD_GUIDE_JOY_L_INGAME_START	[IMG_BUTTON_MINUS] + [IMG_BUTTON_SR]  START鍵
SYS_HUD_GUIDE_JOY_R_INGAME_START	[IMG_BUTTON_PLUS] + [IMG_BUTTON_SR]  START鍵
SYS_HUD_GUIDE_JOY_L_INGAME_SELECT	[IMG_BUTTON_MINUS] + [IMG_BUTTON_SL]  SELECT鍵
SYS_HUD_GUIDE_JOY_R_INGAME_SELECT	[IMG_BUTTON_PLUS] + [IMG_BUTTON_SL]  SELECT鍵
SYS_HUD_GUIDE_JOY_L_INGAME_QUIT_ONLINE	[IMG_BUTTON_MINUS] + [IMG_BUTTON_ZL]  退出線上遊玩
SYS_HUD_GUIDE_JOY_R_INGAME_QUIT_ONLINE	[IMG_BUTTON_PLUS] + [IMG_BUTTON_ZR]  退出線上遊玩
SYS_HUD_GUIDE_JOY_L_DETAILS_NEXT	[IMG_BUTTON_CLOVER_R]  繼續
SYS_HUD_GUIDE_JOY_R_DETAILS_NEXT	[IMG_BUTTON_CLOVER_R]  繼續
SYS_HUD_GUIDE_JOY_L_COMMIT	[IMG_BUTTON_CLOVER_L]  確定
SYS_HUD_GUIDE_JOY_R_COMMIT	[IMG_BUTTON_CLOVER_L]  確定
SYS_HUD_GUIDE_JOY_L_CANCEL	[IMG_BUTTON_CLOVER_D]  復原
SYS_HUD_GUIDE_JOY_R_CANCEL	[IMG_BUTTON_CLOVER_D]  復原
SYS_HUD_GUIDE_JOY_L_NETPLAY_OPTIONAL_MODE	[IMG_BUTTON_CLOVER_L]  開啟低延遲通訊模式
SYS_HUD_GUIDE_JOY_R_NETPLAY_OPTIONAL_MODE	[IMG_BUTTON_CLOVER_L]  開啟低延遲通訊模式
SYS_HUD_GUIDE_JOY_L_NETPLAY_PRIMARY_MODE	[IMG_BUTTON_CLOVER_L]  關閉低延遲通訊模式
SYS_HUD_GUIDE_JOY_R_NETPLAY_PRIMARY_MODE	[IMG_BUTTON_CLOVER_L]  關閉低延遲通訊模式
SYS_HUD_GUIDE_LARK_HOME	[IMG_BUTTON_LARK_RT]  HOME選單
SYS_HUD_GUIDE_LARK_HOME2	[IMG_BUTTON_LARK_RT] : [IMG_BUTTON_HOME]
SYS_HUD_GUIDE_LARK_R_HOME	[IMG_BUTTON_LARK_RIGHT_DPAD]  HOME選單
SYS_HUD_GUIDE_LARK_R_HOME2	[IMG_BUTTON_LARK_RIGHT_DPAD] : [IMG_BUTTON_HOME]
SYS_HUD_GUIDE_LUCIA_HOME	[IMG_BUTTON_LUCIA_ZR]  HOME選單
SYS_HUD_GUIDE_LUCIA_HOME2	[IMG_BUTTON_LUCIA_ZR] : [IMG_BUTTON_HOME]
SYS_HUD_GUIDE_LARK_CAPTURE	[IMG_BUTTON_LARK_LT]  拍攝
SYS_HUD_GUIDE_LARK_CAPTURE2	[IMG_BUTTON_LARK_LT] : [IMG_BUTTON_CAPTURE]
SYS_HUD_GUIDE_LARK_L_CAPTURE	[IMG_BUTTON_LARK_LEFT_A]  拍攝
SYS_HUD_GUIDE_LARK_L_CAPTURE2	[IMG_BUTTON_LARK_LEFT_A] : [IMG_BUTTON_CAPTURE]
SYS_HUD_GUIDE_LUCIA_CAPTURE	[IMG_BUTTON_LUCIA_ZL]  拍攝
SYS_HUD_GUIDE_LUCIA_CAPTURE2	[IMG_BUTTON_LUCIA_ZL] : [IMG_BUTTON_CAPTURE]
SYS_HUD_GUIDE_LARK_CONFIRM	[IMG_BUTTON_A]  確定
SYS_HUD_GUIDE_LARK_BACK	[IMG_BUTTON_B]  返回
SYS_HUD_GUIDE_LARK_DETAILS	[IMG_BUTTON_LARK_START]  詳情
SYS_HUD_GUIDE_LARK_MOVE	[IMG_BUTTON_LARK_SELECT]  移動
SYS_HUD_GUIDE_LARK_MOVE2	[IMG_BUTTON_LARK_SELECT]  移動（長按則排序）
SYS_HUD_GUIDE_LARK_SORT	[IMG_BUTTON_LARK_SELECT]  長按則排序
SYS_HUD_GUIDE_LARK_PLAY	[IMG_BUTTON_A]  開始
SYS_HUD_GUIDE_LARK_GUIDE	[IMG_BUTTON_LARK_START]  操作指南
SYS_HUD_GUIDE_LARK_EXCHANGE	[IMG_BUTTON_LARK_SELECT]  更換1P/2P
SYS_HUD_GUIDE_LARK_VOICE_CHAT	[IMG_BUTTON_LARK_START]  如何進行語音聊天？
SYS_HUD_GUIDE_LARK_PROMOTION	[IMG_BUTTON_LARK_START]  關於專用控制器
SYS_HUD_GUIDE_LARK_INGAME_PAUSE	[IMG_BUTTON_LARK_LT] + [IMG_BUTTON_LARK_RT]  中斷選單
SYS_HUD_GUIDE_LARK_INGAME_QUIT_ONLINE	[IMG_BUTTON_LARK_LT] + [IMG_BUTTON_LARK_RT]  退出線上遊玩
SYS_HUD_GUIDE_LARK_DETAILES_NEXT	[IMG_BUTTON_A]  繼續
SYS_HUD_GUIDE_LARK_COMMIT	[IMG_BUTTON_LARK_SELECT]  確定
SYS_HUD_GUIDE_LARK_CANCEL	[IMG_BUTTON_B]  復原
SYS_HUD_GUIDE_LARK_NETPLAY_OPTIONAL_MODE	[IMG_BUTTON_LARK_SELECT]  開啟低延遲通訊模式
SYS_HUD_GUIDE_LARK_NETPLAY_PRIMARY_MODE	[IMG_BUTTON_LARK_SELECT]  關閉低延遲通訊模式
SYS_HUD_GUIDE_LARK_L_CONFIRM	[IMG_BUTTON_A]  確定
SYS_HUD_GUIDE_LARK_L_BACK	[IMG_BUTTON_B]  返回
SYS_HUD_GUIDE_LARK_L_DETAILS	[IMG_BUTTON_X]  詳情
SYS_HUD_GUIDE_LARK_L_MOVE	[IMG_BUTTON_Y]  移動
SYS_HUD_GUIDE_LARK_L_MOVE2	[IMG_BUTTON_Y]  移動（長按則排序）
SYS_HUD_GUIDE_LARK_L_SORT	[IMG_BUTTON_Y]  長按則排序
SYS_HUD_GUIDE_LARK_L_PLAY	[IMG_BUTTON_A]  開始
SYS_HUD_GUIDE_LARK_L_GUIDE	[IMG_BUTTON_X]  操作指南
SYS_HUD_GUIDE_LARK_L_EXCHANGE	[IMG_BUTTON_Y]  更換1P/2P
SYS_HUD_GUIDE_LARK_L_VOICE_CHAT	[IMG_BUTTON_X]  如何進行語音聊天？
SYS_HUD_GUIDE_LARK_L_PROMOTION	[IMG_BUTTON_X]  關於專用控制器
SYS_HUD_GUIDE_LARK_L_INGAME_PAUSE	[IMG_BUTTON_LARK_LEFT_B]  中斷選單
SYS_HUD_GUIDE_LARK_L_INGAME_START	[IMG_BUTTON_LARK_START]  START鍵
SYS_HUD_GUIDE_LARK_L_INGAME_SELECT	[IMG_BUTTON_LARK_SELECT]  SELECT鍵
SYS_HUD_GUIDE_LARK_L_INGAME_QUIT_ONLINE	[IMG_BUTTON_LARK_LEFT_B]  退出線上遊玩
SYS_HUD_GUIDE_LARK_L_DETAILES_NEXT	[IMG_BUTTON_A]  繼續
SYS_HUD_GUIDE_LARK_L_COMMIT	[IMG_BUTTON_Y]  確定
SYS_HUD_GUIDE_LARK_L_CANCEL	[IMG_BUTTON_B]  復原
SYS_HUD_GUIDE_LARK_L_NETPLAY_OPTIONAL_MODE	[IMG_BUTTON_Y]  開啟低延遲通訊模式
SYS_HUD_GUIDE_LARK_L_NETPLAY_PRIMARY_MODE	[IMG_BUTTON_Y]  關閉低延遲通訊模式
SYS_HUD_GUIDE_LARK_R_CONFIRM	[IMG_BUTTON_LARK_RIGHT_A]  確定
SYS_HUD_GUIDE_LARK_R_BACK	[IMG_BUTTON_LARK_RIGHT_B]  返回
SYS_HUD_GUIDE_LARK_R_DETAILS	[IMG_BUTTON_CLOVER_R]  詳情
SYS_HUD_GUIDE_LARK_R_MOVE	[IMG_BUTTON_CLOVER_U]  移動
SYS_HUD_GUIDE_LARK_R_MOVE2	[IMG_BUTTON_CLOVER_U]  移動（長按則排序）
SYS_HUD_GUIDE_LARK_R_SORT	[IMG_BUTTON_CLOVER_U]  長按則排序
SYS_HUD_GUIDE_LARK_R_PLAY	[IMG_BUTTON_LARK_RIGHT_A]  開始
SYS_HUD_GUIDE_LARK_R_GUIDE	[IMG_BUTTON_CLOVER_R]  操作指南
SYS_HUD_GUIDE_LARK_R_EXCHANGE	[IMG_BUTTON_CLOVER_U]  更換1P/2P
SYS_HUD_GUIDE_LARK_R_VOICE_CHAT	[IMG_BUTTON_CLOVER_R]  如何進行語音聊天？
SYS_HUD_GUIDE_LARK_R_PROMOTION	[IMG_BUTTON_CLOVER_R]  關於專用控制器
SYS_HUD_GUIDE_LARK_R_INGAME_PAUSE	[IMG_BUTTON_CLOVER_D]  中斷選單
SYS_HUD_GUIDE_LARK_R_INGAME_START	[IMG_BUTTON_CLOVER_R]  START鍵
SYS_HUD_GUIDE_LARK_R_INGAME_SELECT	[IMG_BUTTON_CLOVER_U]  SELECT鍵
SYS_HUD_GUIDE_LARK_R_INGAME_QUIT_ONLINE	[IMG_BUTTON_CLOVER_D]  退出線上遊玩
SYS_HUD_GUIDE_LARK_R_DETAILES_NEXT	[IMG_BUTTON_LARK_RIGHT_A]  繼續
SYS_HUD_GUIDE_LARK_R_COMMIT	[IMG_BUTTON_CLOVER_U]  確定
SYS_HUD_GUIDE_LARK_R_CANCEL	[IMG_BUTTON_LARK_RIGHT_B]  復原
SYS_HUD_GUIDE_LARK_R_NETPLAY_OPTIONAL_MODE	[IMG_BUTTON_CLOVER_U]  開啟低延遲通訊模式
SYS_HUD_GUIDE_LARK_R_NETPLAY_PRIMARY_MODE	[IMG_BUTTON_CLOVER_U]  關閉低延遲通訊模式
SYS_HUD_GUIDE_LARK_LR_CONFIRM	[IMG_BUTTON_LARK_RIGHT_A]  確定
SYS_HUD_GUIDE_LARK_LR_BACK	[IMG_BUTTON_LARK_RIGHT_B]  返回
SYS_HUD_GUIDE_LARK_LR_DETAILS	[IMG_BUTTON_LARK_START]  詳情
SYS_HUD_GUIDE_LARK_LR_MOVE	[IMG_BUTTON_LARK_SELECT]  移動
SYS_HUD_GUIDE_LARK_LR_MOVE2	[IMG_BUTTON_LARK_SELECT]  移動（長按則排序）
SYS_HUD_GUIDE_LARK_LR_SORT	[IMG_BUTTON_LARK_SELECT]  長按則排序
SYS_HUD_GUIDE_LARK_LR_PLAY	[IMG_BUTTON_LARK_RIGHT_A]  開始
SYS_HUD_GUIDE_LARK_LR_GUIDE	[IMG_BUTTON_LARK_START]  操作指南
SYS_HUD_GUIDE_LARK_LR_EXCHANGE	[IMG_BUTTON_LARK_SELECT]  更換1P/2P
SYS_HUD_GUIDE_LARK_LR_VOICE_CHAT	[IMG_BUTTON_LARK_START]  如何進行語音聊天？
SYS_HUD_GUIDE_LARK_LR_PROMOTION	[IMG_BUTTON_LARK_START]  關於專用控制器
SYS_HUD_GUIDE_LARK_LR_INGAME_PAUSE	[IMG_BUTTON_LARK_LEFT_B]  中斷選單
SYS_HUD_GUIDE_LARK_LR_INGAME_START	[IMG_BUTTON_LARK_START]  START鍵
SYS_HUD_GUIDE_LARK_LR_INGAME_SELECT	[IMG_BUTTON_LARK_SELECT]  SELECT鍵
SYS_HUD_GUIDE_LARK_LR_INGAME_QUIT_ONLINE	[IMG_BUTTON_LARK_LEFT_B]  退出線上遊玩
SYS_HUD_GUIDE_LARK_LR_DETAILES_NEXT	[IMG_BUTTON_LARK_RIGHT_A]  繼續
SYS_HUD_GUIDE_LARK_LR_COMMIT	[IMG_BUTTON_LARK_SELECT]  確定
SYS_HUD_GUIDE_LARK_LR_CANCEL	[IMG_BUTTON_LARK_RIGHT_B]  復原
SYS_HUD_GUIDE_LARK_LR_NETPLAY_OPTIONAL_MODE	[IMG_BUTTON_LARK_SELECT]  開啟低延遲通訊模式
SYS_HUD_GUIDE_LARK_LR_NETPLAY_PRIMARY_MODE	[IMG_BUTTON_LARK_SELECT]  關閉低延遲通訊模式
SYS_HUD_GUIDE_LUCIA_CONFIRM	[IMG_BUTTON_A]  確定
SYS_HUD_GUIDE_LUCIA_BACK	[IMG_BUTTON_B]  返回
SYS_HUD_GUIDE_LUCIA_DETAILS	[IMG_BUTTON_X]  詳情
SYS_HUD_GUIDE_LUCIA_MOVE	[IMG_BUTTON_Y]  移動
SYS_HUD_GUIDE_LUCIA_MOVE2	[IMG_BUTTON_Y]  移動 （長按則排序）
SYS_HUD_GUIDE_LUCIA_SORT	[IMG_BUTTON_Y]  長按則排序
SYS_HUD_GUIDE_LUCIA_PLAY	[IMG_BUTTON_A]  開始
SYS_HUD_GUIDE_LUCIA_GUIDE	[IMG_BUTTON_X]  操作指南
SYS_HUD_GUIDE_LUCIA_EXCHANGE	[IMG_BUTTON_Y]  更換1P/2P
SYS_HUD_GUIDE_LUCIA_VOICE_CHAT	[IMG_BUTTON_X]  如何語音聊天？
SYS_HUD_GUIDE_LUCIA_PROMOTION	[IMG_BUTTON_X]  關於專用控制器
SYS_HUD_GUIDE_LUCIA_INGAME_PAUSE	[IMG_BUTTON_LUCIA_ZL] + [IMG_BUTTON_LUCIA_ZR]  中斷選單
SYS_HUD_GUIDE_LUCIA_INGAME_QUIT_ONLINE	[IMG_BUTTON_LUCIA_ZL] + [IMG_BUTTON_LUCIA_ZR]  退出線上遊玩
SYS_HUD_GUIDE_LUCIA_DETAILES_NEXT	[IMG_BUTTON_A]  繼續
SYS_HUD_GUIDE_LUCIA_COMMIT	[IMG_BUTTON_Y]  確定
SYS_HUD_GUIDE_LUCIA_CANCEL	[IMG_BUTTON_B]  復原
SYS_HUD_GUIDE_LUCIA_NETPLAY_OPTIONAL_MODE	[IMG_BUTTON_Y]  開啟低延遲通訊模式
SYS_HUD_GUIDE_LUCIA_NETPLAY_PRIMARY_MODE	[IMG_BUTTON_Y]  關閉低延遲通訊模式
SYS_INFO_NICKNAME_OWN	[OWN_NAME]
SYS_INFO_NICKNAME_HOST	[HOST_NAME]
SYS_INFO_NICKNAME_GUEST	[GUEST_NAME]
SYS_INFO_SESSION_PASSWORD	[PASSWORD]
SYS_INFO_NETWORK_UNSTABLE	您可以在「[IMG_SETTINGS] 設定」更改通訊模式
SYS_MENU_ROOT_SESSION_COUNTER	[NUMBER_OF_SESSIONS]
SYS_MENU_ONLINE_ITEM_SESSION1	[ROOM1]
SYS_MENU_ONLINE_ITEM_SESSION2	[ROOM2]
SYS_MENU_ONLINE_ITEM_SESSION3	[ROOM3]
SYS_MENU_ONLINE_ITEM_SESSION4	[ROOM4]
SYS_MENU_ONLINE_ITEM_SESSION5	[ROOM5]
SYS_MENU_ONLINE_ITEM_SESSION6	[ROOM6]
SYS_MENU_ONLINE_DESC_SESSION_LIST	選擇要一起遊玩的朋友　[IMG_BUTTON_Y] 重新搜尋
SYS_MENU_ONLINE_DESC_SESSION_LIST_JOY_L	選擇要一起遊玩的朋友　[IMG_BUTTON_CLOVER_L] 重新搜尋
SYS_MENU_ONLINE_DESC_SESSION_LIST_JOY_R	選擇要一起遊玩的朋友　[IMG_BUTTON_CLOVER_L] 重新搜尋
SYS_MENU_ONLINE_DESC_SESSION_LIST_LARK	選擇要一起遊玩的朋友　[IMG_BUTTON_LARK_SELECT] 重新搜尋
SYS_MENU_ONLINE_DESC_SESSION_LIST_LARK_L	選擇要一起遊玩的朋友　[IMG_BUTTON_Y] 重新搜尋
SYS_MENU_ONLINE_DESC_SESSION_LIST_LARK_R	選擇要一起遊玩的朋友　[IMG_BUTTON_CLOVER_U] 重新搜尋
SYS_MENU_ONLINE_DESC_SESSION_LIST_LARK_LR	選擇要一起遊玩的朋友　[IMG_BUTTON_LARK_SELECT] 重新搜尋
SYS_MENU_ONLINE_DESC_SESSION_LIST_LUCIA	選擇要一起遊玩的朋友　[IMG_BUTTON_Y] 重新搜尋
SYS_MENU_ONLINE_DESC_SESSION_LIST_INVITE	選擇要會合的朋友　[IMG_BUTTON_Y] 重新搜尋
SYS_MENU_ONLINE_DESC_SESSION_LIST_JOY_L_INVITE	選擇要會合的朋友　[IMG_BUTTON_CLOVER_L] 重新搜尋
SYS_MENU_ONLINE_DESC_SESSION_LIST_JOY_R_INVITE	選擇要會合的朋友　[IMG_BUTTON_CLOVER_L] 重新搜尋
SYS_MENU_ONLINE_DESC_SESSION_LIST_LARK_INVITE	選擇要會合的朋友　[IMG_BUTTON_LARK_SELECT] 重新搜尋
SYS_MENU_ONLINE_DESC_SESSION_LIST_LARK_L_INVITE	選擇要會合的朋友　[IMG_BUTTON_Y] 重新搜尋
SYS_MENU_ONLINE_DESC_SESSION_LIST_LARK_R_INVITE	選擇要會合的朋友　[IMG_BUTTON_CLOVER_U] 重新搜尋
SYS_MENU_ONLINE_DESC_SESSION_LIST_LARK_LR_INVITE	選擇要會合的朋友　[IMG_BUTTON_LARK_SELECT] 重新搜尋
SYS_MENU_ONLINE_DESC_SESSION_LIST_LUCIA_INVITE	選擇要會合的朋友　[IMG_BUTTON_Y] 重新搜尋
SYS_MENU_DETAILS_DESC_RELEASE_INFO	[DETAILED_COMPANY]　　[DETAILED_RELEASE_YEAR]年發售
SYS_MENU_DETAILS_DESC_PLAY_INFO_LONG_TIME	遊玩人數：[DETAILED_PLAYERS]人　　遊玩時間：[DETAILED_PLAYTIME]小時[DETAILED_PLAYTIME_MIN]分鐘
SYS_MENU_DETAILS_DESC_PLAY_INFO_SHORT_TIME	遊玩人數：[DETAILED_PLAYERS]人　　遊玩時間：[DETAILED_PLAYTIME_MIN]分鐘
SYS_MENU_DETAILS_DESC_PLAY_INFO_NO_TIME	遊玩人數：[DETAILED_PLAYERS]人
SYS_MENU_DETAIL_PAGE	[DETAIL_NOW_PAGE] / [DETAIL_ALL_PAGE]
SYS_MENU_SAVESLOT_ITEM_EMPTY	儲存資料[SAVE_INDEX]
SYS_MENU_SAVESLOT_ITEM_VALID	儲存資料[SAVE_INDEX]\n[SAVE_YEAR]/[SAVE_MONTH]/[SAVE_DAY] [SAVE_HOUR]:[SAVE_MINUTE]
SYS_MENU_SPECIAL2_TEXT	SPECIAL[NUMBER]
SYS_MENU_FRIENDPRESENCE	正在遊玩的遊戲：[FRIENDPRESENCE_TITLENAME]
SYS_NOTIFICATION_OTHER_PLAYER_MISSING_TEXT	已與[GUEST_NAME]切斷通訊。\n將繼續遊玩並等待朋友。
SYS_NOTIFICATION_OTHER_PLAYER_MISSING2_TEXT	已與[HOST_NAME]切斷通訊。
SYS_NOTIFICATION_UNSTABLE_NETWORK_TEXT	由於您與對方的通訊環境不佳，可能無法順暢遊玩。\n您可以在「[IMG_SETTINGS_L] 設定」更改通訊模式。
SYS_NOTIFICATION_OPERATION_DENIED_TEXT	[HOST_NAME]正在操作。
SYS_NOTIFICATION_OPERATION_DENIED2_TEXT	[GUEST_NAME]正在操作。
SYS_POPUP_GUIDE_PRO_CONTROLLER_SELECT	按[IMG_BUTTON_MINUS]鍵移動游標
SYS_POPUP_GUIDE_PRO_CONTROLLER_START	按[IMG_BUTTON_PLUS]鍵開始遊戲
SYS_POPUP_GUIDE_JOY_L_CONTROLLER_SELECT	[IMG_BUTTON_MINUS] + [IMG_BUTTON_SL]移動游標
SYS_POPUP_GUIDE_JOY_L_CONTROLLER_START	[IMG_BUTTON_MINUS] + [IMG_BUTTON_SR]開始遊戲
SYS_POPUP_GUIDE_JOY_R_CONTROLLER_SELECT	[IMG_BUTTON_PLUS] + [IMG_BUTTON_SL]移動游標
SYS_POPUP_GUIDE_JOY_R_CONTROLLER_START	[IMG_BUTTON_PLUS] + [IMG_BUTTON_SR]開始遊戲
SYS_POPUP_GUIDE_LARK_L_CONTROLLER_SELECT	按[IMG_BUTTON_LARK_SELECT]鍵移動游標
SYS_POPUP_GUIDE_LARK_L_CONTROLLER_START	按[IMG_BUTTON_LARK_START]鍵開始遊戲
SYS_POPUP_GUIDE_LARK_R_CONTROLLER_SELECT	按[IMG_BUTTON_CLOVER_U]鍵移動游標
SYS_POPUP_GUIDE_LARK_R_CONTROLLER_START	按[IMG_BUTTON_CLOVER_R]鍵開始遊戲
SYS_POPUP_GUIDE_PRO_PAUSE_MENU	[IMG_BUTTON_ZL] + [IMG_BUTTON_ZR]中斷遊戲
SYS_POPUP_GUIDE_JOY_L_PAUSE_MENU	[IMG_BUTTON_MINUS] + [IMG_BUTTON_ZL]中斷遊戲
SYS_POPUP_GUIDE_JOY_R_PAUSE_MENU	[IMG_BUTTON_PLUS] + [IMG_BUTTON_ZR]中斷遊戲
SYS_POPUP_GUIDE_LARK_PAUSE_MENU	[IMG_BUTTON_LARK_LT] + [IMG_BUTTON_LARK_RT]中斷遊戲
SYS_POPUP_GUIDE_LARK_L_PAUSE_MENU	按[IMG_BUTTON_LARK_LEFT_B]鍵中斷遊戲
SYS_POPUP_GUIDE_LARK_R_PAUSE_MENU	按[IMG_BUTTON_CLOVER_D]鍵中斷遊戲
SYS_POPUP_GUIDE_LUCIA_PAUSE_MENU	[IMG_BUTTON_LUCIA_ZL] + [IMG_BUTTON_LUCIA_ZR]中斷遊戲
SYS_POPUP_GUIDE_PRO_SWAP_PLAYERS	在中斷選單按[IMG_BUTTON_Y]鍵可更換1P/2P
SYS_POPUP_GUIDE_JOY_L_SWAP_PLAYERS	在中斷選單按[IMG_BUTTON_CLOVER_L]鍵可更換1P/2P
SYS_POPUP_GUIDE_JOY_R_SWAP_PLAYERS	在中斷選單按[IMG_BUTTON_CLOVER_L]鍵可更換1P/2P
SYS_POPUP_GUIDE_FINGER_CURSOR	[IMG_GAMEPAD_STICK_R]為手掌游標，按[IMG_BUTTON_STICK_R]為拍手
SYS_POPUP_GUIDE_LARK_SYSTEM_BUTTON_HOME	HOME選單按[IMG_BUTTON_LARK_RT]鍵
SYS_POPUP_GUIDE_LARK_SYSTEM_BUTTON_CAPTURE	拍攝按[IMG_BUTTON_LARK_LT]鍵
SYS_POPUP_GUIDE_LARK_R_SYSTEM_BUTTON_HOME	HOME選單按[IMG_BUTTON_LARK_RIGHT_DPAD]鍵
SYS_POPUP_GUIDE_LARK_L_SYSTEM_BUTTON_CAPTURE	拍攝按[IMG_BUTTON_LARK_LEFT_A]鍵
SYS_POPUP_GUIDE_LUCIA_SYSTEM_BUTTON_HOME	HOME選單按[IMG_BUTTON_LUCIA_ZR]鍵
SYS_POPUP_GUIDE_LUCIA_SYSTEM_BUTTON_CAPTURE	拍攝按[IMG_BUTTON_LUCIA_ZL]鍵
SYS_POPUP_GUIDE_PRO_REWIND	失誤也沒有關係。長按[IMG_BUTTON_ZL] + [IMG_BUTTON_ZR]就會倒回。\n可以在看中的地方重來。
SYS_POPUP_GUIDE_JOY_L_REWIND	失誤也沒有關係。長按[IMG_BUTTON_MINUS] + [IMG_BUTTON_ZL]就會倒回。\n可以在看中的地方重來。
SYS_POPUP_GUIDE_JOY_R_REWIND	失誤也沒有關係。長按[IMG_BUTTON_PLUS] + [IMG_BUTTON_ZR]就會倒回。\n可以在看中的地方重來。
SYS_POPUP_GUIDE_LARK_REWIND	失誤也沒有關係。長按[IMG_BUTTON_LARK_LT] + [IMG_BUTTON_LARK_RT]就會倒回。\n可以在看中的地方重來。
SYS_POPUP_GUIDE_LARK_L_REWIND	失誤也沒有關係。長按[IMG_BUTTON_LARK_LEFT_B]就會倒回。\n可以在看中的地方重來。
SYS_POPUP_GUIDE_LARK_R_REWIND	失誤也沒有關係。長按[IMG_BUTTON_CLOVER_D]就會倒回。\n可以在看中的地方重來。
SYS_POPUP_GUIDE_LUCIA_REWIND	失誤也沒有關係。長按[IMG_BUTTON_LUCIA_ZL] + [IMG_BUTTON_LUCIA_ZR]就會倒回。\n可以在看中的地方重來。
SYS_HUD_GUIDE_PRO_INGAME_PAUSE_WITH_REWIND	[IMG_BUTTON_ZL] + [IMG_BUTTON_ZR]  中斷選單（長按則倒回）
SYS_HUD_GUIDE_JOY_L_INGAME_PAUSE_WITH_REWIND	[IMG_BUTTON_MINUS] + [IMG_BUTTON_ZL]  中斷選單（長按則倒回）
SYS_HUD_GUIDE_JOY_R_INGAME_PAUSE_WITH_REWIND	[IMG_BUTTON_PLUS] + [IMG_BUTTON_ZR]  中斷選單（長按則倒回）
SYS_HUD_GUIDE_LARK_INGAME_PAUSE_WITH_REWIND	[IMG_BUTTON_LARK_LT] + [IMG_BUTTON_LARK_RT]  中斷選單（長按則倒回）
SYS_HUD_GUIDE_LARK_L_INGAME_PAUSE_WITH_REWIND	[IMG_BUTTON_LARK_LEFT_B]  中斷選單（長按則倒回）
SYS_HUD_GUIDE_LARK_R_INGAME_PAUSE_WITH_REWIND	[IMG_BUTTON_CLOVER_D]  中斷選單（長按則倒回）
SYS_HUD_GUIDE_LARK_LR_INGAME_PAUSE_WITH_REWIND	[IMG_BUTTON_LARK_LEFT_B]  中斷選單（長按則倒回）
SYS_HUD_GUIDE_LUCIA_INGAME_PAUSE_WITH_REWIND	[IMG_BUTTON_LUCIA_ZL] + [IMG_BUTTON_LUCIA_ZR]  中斷選單（長按則倒回）
SYS_SORT_HEADING_PLAY_TIME	[VALUE]分鐘
SYS_SORT_HEADING_DATE_PLAYED_1	[YEAR]/[MONTH]/[DAY]
SYS_SORT_HEADING_DATE_PLAYED_2	[MONTH]/[DAY]
SYS_USER_GUIDE_JOY_L_COMBINATION	[IMG_BUTTON_MINUS] + [IMG_BUTTON_SL] SELECT    [IMG_BUTTON_MINUS] + [IMG_BUTTON_SR] START
SYS_USER_GUIDE_JOY_R_COMBINATION	[IMG_BUTTON_PLUS] + [IMG_BUTTON_SL] SELECT    [IMG_BUTTON_PLUS] + [IMG_BUTTON_SR] START
SYS_USER_GUIDE_LARK_COMBINATION	[IMG_BUTTON_LARK_LT] + [IMG_BUTTON_LARK_RT] 中斷選單
SYS_USER_GUIDE_LUCIA_COMBINATION	[IMG_BUTTON_LUCIA_ZL] + [IMG_BUTTON_LUCIA_ZR] 中斷選單
SYS_USER_GUIDE_SYSTEM_HOME	[IMG_BUTTON_HOME] HOME選單
SYS_USER_GUIDE_SYSTEM_CAPTURE	[IMG_BUTTON_CAPTURE] 拍攝
SYS_USER_GUIDE_SYSTEM_CAPTURE2	拍攝 [IMG_BUTTON_CAPTURE]
titles
S-2156_j	ボンバザル
S-2002_j	ラッシング・ビート乱 複製都市
S-2025_j	ブレス オブ ファイアⅡ 使命の子
S-2003_j	ブレス オブ ファイア 竜の戦士
S-2004_j	デモンズブレイゾン 魔界村 紋章編
S-2026_j	くにおくんのドッジボールだよ全員集合！
S-2060_j	スーパードンキーコング 2
S-2061_j	スーパードンキーコング 3
S-2055_j	スーパードンキーコング
S-2139_j	対決!!ブラスナンバーズ
S-2051_j	MOTHER2 ギーグの逆襲
S-2005_j	F-ZERO
S-2027_j	Fire Emblem 紋章の謎
S-2028_j	Fire Emblem 聖戦の系譜
S-2037_j	牧場物語
S-2006_j	戦え原始人3 主役はやっぱりJOE&MAC
S-2169_j	JOE&MAC 戦え原始人
S-2029_j	星之卡比 超級豪華版
S-2007_j	カービィボウル
S-2008_j	星之卡比3
S-2151_j	マジカルドロップ2
S-2044_j	マリオのスーパーピクロス
S-2034_j	パネルでポン
S-2009_j	パイロットウイングス
S-2010_j	Pop'nツインビー
S-2145_j	サイコドリーム
S-2148_j	真‧女神轉生Ⅱ
S-2149_j	真・女神転生if...
S-2147_j	真‧女神轉生
S-2031_j	星際火狐2
S-2011_j	星際火狐
S-2012_j	ワイルドトラックス
S-2032_j	すごいへべれけ
S-2013_j	SUPER E.D.F.
S-2014_j	スーパーファミリーテニス
S-2015_j	超魔界村®
S-2033_j	超級瑪利歐收藏輯
S-2016_j	超級瑪利歐賽車
S-2016_j-sp1	超級瑪利歐賽車
S-2017_j	超級瑪利歐世界
S-2017_j-sp1	超級瑪利歐世界
S-2018_j	超級密特羅德
S-2018_j-sp1	超級密特羅德
S-2019_j	スーパーパンチアウト!!
S-2019_j-sp1	スーパーパンチアウト!!
S-2020_j	超級魔法氣泡通
S-2021_j	スーパーフォーメーションサッカー
S-2022_j	スーパーテニス・ワールドサーキット
S-2142_j	ファイヤー・ファイティング
S-2146_j	DEAD DANCE
S-2049_j	ワイルドガンズ
S-2023_j	超級瑪利歐 ヨッシーアイランド
S-2024_j	薩爾達傳說 神々のトライフォース
