Bmenu.msbt
$BmenuBackGuide	返回
Title_ModeName_Battle	对战模式
Title_ModeName_Online	线上模式
Title_ModeName_Local	本地联机模式
$BMenuPartsModeSelTitleText	主菜单
$BMenuModeSelLocalBtnTitle	本地联机模式
$BMenuModeSelOfflineBtnTitle	对战模式
$BMenuModeSelOnlineBtnTitle	线上模式
ModeSelDetail_Online	可以在线上与世界各地的人游玩，\n或是通过暗号与远方的朋友游玩。
ModeSelDetail_NoNet	可以与CP角色进行4人游玩，\n或是与朋友2人之间通过\n分享游玩来享受游戏。
ModeSelDetail_LocalNet	只要有与人数相同的软件与主机，\n就能通过本地联机\n最多4人一起游玩。
$BmenuPartsPlayerEntrySumTitleText	玩家人数
$BmenuPartsEntrySumBtnText1P	1人
$BmenuPartsEntrySumBtnText2P	2人
PlayerNum_P1	1P
PlayerNum_P2	2P
PlayerNum_P3	3P
PlayerNum_P4	4P
$BMenuPartsRuleSelTitleText	游戏规则
$BMenuPartsRuleSelGrandPrixBtnText	美食大赏
RuleSelTitle_GrandPrix	美食大赏
$BMenuPartsRuleSelRaceBtnText	单人比赛
RuleSelTitle_Race	单人比赛
$BMenuPartsRuleSelBonusBtnText	单人小游戏
RuleSelTitle_Bonus	单人小游戏
$BMenuPartsRuleSelRoundBtnText	单人生存战
RuleSelTitle_Round	单人生存战
$BMenuPartsRuleSelFreeTrainingBtnText	自由练习
RuleSelTitle_Training	自由练习
RuleSelDetail_GrandPrix	可以游玩包含比赛、小游戏，\n以及生存战这三种游戏的完整美食节！\n可以获得“角色点心”。
RuleSelDetail_Race	以终点的草莓堆为目标，\n在1个精选的关卡菜单中驰骋吧！\n可以获得“角色点心”。
RuleSelDetail_Bonus	简单又快速的小游戏。\n按照被随机选中的1种规则，\n吃掉比其他人更多的草莓吧！
RuleSelDetail_Round	在精选的主餐中，使用复制食物\n进行有机会大逆转的生存战吧！\n可以获得“角色点心”。
RuleSelDetail_Training	在宽广的游乐场中自由练习。\n也能自由地尝试各自复制食物。\n与朋友们一起享用美食、一起滚动吧。\nBGM每过几分钟就会更换一次！
$BmenuPartsMatchingGroupTitleText	选择团队
$BmenuPartsMatchingGroupAddText	{[0412|9500]}/{[0411|9400]}创建团队
$BmenuPartsMatchingGroupReloadText	更新列表
$BmenuPartsMatchingGroupNotFound	没有团队。\n请按{[0412|9500]}/{[0411|9400]}创建团队，\n或按{[040a|6100]}更新列表。
$BMenuPartsMatchingWaitTitleText	正在配对……
$BMenuPartsTypeSelTitleText	配对选择
$BMenuTypeSelBtnKeyword	暗号配对
$BMenuTypeSelBtnOthers	和任何人配对
BMenuTypeSel_KeywordHeaderText	请输入暗号
Cmn.msbt
$Back	返回
TimeDisplaySecPunctuation	:
$CmnTimeExtraInnings	加时
$CmnBtnMatchingCloseText	截止
$CmnBattleRecordDifficulty	CP等级
$CmnGourmetGaugeName	美食级别
GourmetRankGuage_Point	{[0302|0000]} / {size[4b00]}{[0302|0100]}{size[6400]}
GourmetRankGuage_MaxRankPoint	{[0302|0000]}
$CmnGourmetRankBarBalloonBonus	奖励
GourmetRankGuage_PointGet	+{[0301|0000]}
$CmnBattleRecordNumOfVictories	获胜次数
$CmnBattleRecordRating	积分
BattleRecord_ChangeNum_Plus	+{[0301|0000]}
BattleRecord_ChangeNum_Minus	-{[0301|0000]}
$CmnEmoteTextL	嗨～！
EmoteText_EmotionC	嗨～！
$CmnEmoteTextR	啊！
EmoteText_EmotionD	啊！
$CmnEmoteTextU	请多指教！
EmoteText_EmotionA	请多指教！
$CmnEmoteTextB	谢谢～！
EmoteText_EmotionB	谢谢～！
KiloSeparator	,
DecimalPoint	.
$NewIconText	NEW!
$CmnPleaseWait	请稍等片刻
Collection.msbt
$CollectionSkinGuideAttach	更换
$CollectionSkinGuideRotate	旋转
$CollectionSkinTitle	更换外表
$CollectionListNameColor	颜色
$CollectionListNameSkin	外表
$CollectionSweetViewTitle	角色点心收藏
CollectionSweetDecor_Decor	装饰蛋糕
CollectionSweetDecor_Remove	从蛋糕移除
$CollectionSweetViewMultiplication	×
$CollectionSweetViewSlash	/
Credit.msbt
Staff	STAFF
GeneralDirector	GENERAL DIRECTOR
GeneralDirector_00	SHINYA KUMAZAKI
SequenceDirector	SEQUENCE DIRECTOR
SequenceDirector_00	SHOTA YAMADA
LevelDesignDirector	LEVEL DESIGN DIRECTOR
LevelDesignDirector_00	KOSUKE YAMAZAKI
GameDesigners	GAME DESIGNERS
GameDesigners_00	YUYA KOZUKA
GameDesigners_01	RYOSUKE SAKAMOTO
TechnicalDirector	TECHNICAL DIRECTOR
TechnicalDirector_00	HIROSHI OHNISHI
LeadActionProgrammer	LEAD ACTION PROGRAMMER
LeadActionProgrammer_00	KATSUYOSHI SUMITOMO
LeadUiProgrammer	LEAD UI PROGRAMMER
LeadUiProgrammer_00	YUSHI UCHIDA
Programmers	PROGRAMMERS
Programmers_00	TAISEI YAMAMOTO
Programmers_01	KAKUYA MAEKUBO
Programmers_02	KEISUKE TAKEMURA
Programmers_03	TAIKI SAKA
Programmers_04	KEITA YAMADA
Programmers_05	HIROMU WATANABE
ArtDirector	ART DIRECTOR
ArtDirector_00	RIKI FUHRMANN
CharacterArtists	CHARACTER ARTISTS
CharacterArtists_00	KENTA MIYAMOTO
CharacterArtists_01	AKIKO HAYASHI
FieldArtists	FIELD ARTISTS
FieldArtists_00	YUKI YOSHIOKA
FieldArtists_01	MAO YAMASE
FieldArtists_02	KEIYA OGAWA
FieldArtists_03	NATSUMI MURAKI
FieldArtists_04	TOMOMI MINAMI
LeadUiArtist	LEAD UI ARTIST
LeadUiArtist_00	KANAKO OMORI
UiArtists	UI ARTISTS
UiArtists_00	FUMIYASU KATO
UiArtists_01	HIKARU USHIKI
UiArtists_02	YUMI TODO
UiArtists_03	TERUHIKO SUZUKI
Movie	MOVIE
Movie_00	D.A.G Inc.
Movie_01	EIKI TAKIZAWA
Movie_02	HISANORI MATSUSHIMA
Movie_03	AKIKO SASAOKA
Movie_04	YUYA SUZUKI
Movie_05	KENRO SHIMIZU
Movie_06	SADAHIRO OKUI
Movie_07	AIKA TAKAHASHI
Movie_08	KEISUKE NISHINA
LeadSound	LEAD SOUND
LeadSound_00	YUUTA OGASAWARA
Sound	SOUND
Sound_00	JUN ISHIKAWA
Sound_01	SHOGO SAKAI
Sound_03	HIROKAZU ANDO
Sound_04	MEGUMI OHARA
Sound_05	YUKI SHIMOOKA
Voice	VOICE
Voice_00	MAKIKO OHMOTO
FratFrameworkProgrammers	FRAT FRAMEWORK PROGRAMMERS
FratFrameworkProgrammers_00	KAZUYA SUETSUGU
FratFrameworkProgrammers_01	TETSUYA NOGE
FratFrameworkProgrammers_02	TOMOKAZU TSURUOKA
FratFrameworkProgrammers_03	RYOICHIRO ATONO
FratFrameworkProgrammers_04	SHINICHI KAWAJI
FratFrameworkProgrammers_05	RUI UCHIDA
FratFrameworkProgrammers_06	AYUMU KATO
FratFrameworkProgrammers_07	YUYA SUZUKI
FratFrameworkProgrammers_08	MASATAKA SESHIMO
FratFrameworkProgrammers_09	KEIGO TSUDA
FratFrameworkProgrammers_10	MUNEMASA KIMURA
FratFrameworkProgrammers_11	TAKASHI MATSUDA
TechnicalSupport	TECHNICAL SUPPORT
TechnicalSupport_00	KAZUYA KONISHI
TechnicalSupport_01	HAJIME IMAIZUMI
TechnicalSupport_02	YOUSUKE FUKUNAGA
TechnicalSupport_03	TAKAAKI KAZUNO
TechnicalSupport_04	TAKASHI NEMOTO
TechnicalSupport_05	JUNICHI AOYAGI
TechnicalSupport_06	HIROAKI NAKANO
TechnicalSupport_07	TATSUYA MURASE
TechnicalSupport_08	AKIO HANYU
TechnicalSupport_09	TATSUHIRO TANOUE
TechnicalSupport_10	TAKESHI MINAGAWA
TechnicalSupport_11	TAKEHIRO OYAMA
TeamSupport	TEAM SUPPORT
TeamSupport_00	YOSHIMI TAKAHASHI
TeamSupport_01	KATSUHIRO SAKODA
Artwork	ARTWORK
Artwork_00	RIEKO KAWAHARA
Artwork_01	YUTO IBARAKI
Artwork_02	EMI IMAMURA
Artwork_03	KEIKO INOUE
Testing	TESTING
Testing_00	MASARU KOBAYASHI
Testing_01	TAKESHI TAMURA
Testing_02	AKIKO OHASHI
Testing_03	MANAMI ONOZUKA
Testing_04	TAIKI MAEDA
Testing_05	YUKI ITONAGA
Testing_06	HAL DEBUG TEAM
Testing_07	Mario Club Co., Ltd.
Testing_08	SHIFT Inc.
LocalizationManagement	LOCALIZATION MANAGEMENT
LocalizationManagement_00	SEIJI OTOGURO
Localization	LOCALIZATION
Localization_00	SHIGERU HASHIGUCHI
Localization_01	KENICHI MASUDA
Localization_02	SHIGERU HIRAYAMA
NoaLocalizationManagement	NOA LOCALIZATION MANAGEMENT
NoaLocalizationManagement_00	REIKO NINOMIYA
NoaLocalizationManagement_01	RICH AMTOWER
NoaLocalizationManagement_02	RAYMOND ELLIGET
NoaLocalizationManagement_03	NICKO GONZALEZ
NoaLocalizationManagement_04	BERENICE HOFSETZ
NoaLocalizationManagement_05	TIM O'LEARY
NoaLocalizationManagement_06	CÉSAR PÉREZ
NoaLocalizationManagement_07	MORGAN RITCHIE
NoaLocalizationManagement_08	THADDÉE WISEUR
NoaLocalizationManagement_09	ÁLEX ZARZA
NoaLocalization	NOA LOCALIZATION
NoaLocalization_00	ANA CELESTE ASCANIO
NoaLocalization_01	MICHAEL BENEDETTO
NoaLocalization_02	BILLY CARROLL
NoaLocalization_03	YANETT CEPEDA VALOR
NoaLocalization_04	KRIS COPELAND
NoaLocalization_05	MARJOLAINE DROUIN
NoaLocalization_06	PALOMA HERNANDEZ
NoaLocalization_07	DUTCH HIXENBAUGH
NoaLocalization_08	SARA HOAD
NoaLocalization_09	MARISSOL KARCZESKI
NoaLocalization_10	KRISTOPHER KATZ
NoaLocalization_11	BRANDON KRAEMER
NoaLocalization_12	KELI DOMINCIANO NAKAMURA
NoaLocalization_13	ERIN PETERSON
NoaLocalization_14	CAROLINA QUESADA
NoaLocalization_15	BABI VELHO BARRETO
NoaLocalization_16	LAUREN WELLS
NoaLocalization_17	LUDOVIC TIENTCHEU PONKIN
NoaLocalization_18	TARYN ZIEGLER
NoaLocalization_19	FELIPE ZYLBERSZTAJN
NoaProductTesting	NOA PRODUCT TESTING
NoaProductTesting_00	KENTARO NISHIMURA
NoaProductTesting_01	KIRK BUCHANAN
NoaProductTesting_02	TOMO ISHIYAMA
NoaProductTesting_03	HITOSHI NISHIZAWA
NoaProductTesting_04	SEAN EGAN
NoaProductTesting_05	TOMOKO MIKAMI
NoaProductTesting_06	ANDY KOLDEN
NoaProductTesting_07	JIM HOLDEMAN
NoaProductTesting_08	MANNA YAMASAKI
NoaProductTesting_09	TOM HERTZOG
NoaProductTesting_10	YOUNG KIM
NoaProductTesting_11	MARKO WALLENIUS
NoaProductTesting_12	MICHAEL SAHLIN
NoaProductTesting_13	JAMES DILLON
NoaProductTesting_14	JOSH YAGI-STANTON
NoaProductTesting_15	CRAIG SO
NoaProductTesting_16	LUISA BAYONA OTERO
NoaProductTesting_17	ROSE HERNANDEZ
NoaProductTesting_18	AGATHA CARVALHAES CAMARGO HORTIZ
NoaProductTesting_19	NICOLAS MORA
NoaProductTesting_20	CAMERON PARENT
NoaProductTesting_21	LIBIA SANTOS SOUZA
NoaProductTesting_22	BRANDON TRUAX
NoaProductTesting_23	FRANCES ECKRICH
NoaProductTesting_24	AARON JONES
NoaProductTesting_25	PRODUCT TESTING TECHNICIANS
NoeLocalisationProducers	NOE LOCALISATION PRODUCERS
NoeLocalisationProducers_00	IVÁN GARRIDO GONZÁLEZ
NoeLocalisationProducers_01	SASKIA DOORSCHODT
NoeLocalisationProducers_02	DARIO DE LEO
NoeLocalisationProducers_03	LIAM HIGGINS
NoeTranslationCoordination	NOE TRANSLATION COORDINATION
NoeTranslationCoordination_00	PIERRE SANCHEZ
NoeTranslationCoordination_01	ANDREA JÄHN
NoeEnglishTranslationSupport	NOE ENGLISH TRANSLATION SUPPORT
NoeEnglishTranslationSupport_00	PATRICK JOYCE
NoeTranslation	NOE TRANSLATION
NoeTranslation_00	CLÉMENCE DIERYCK
NoeTranslation_01	JEAN-PAUL HAUSMANN
NoeTranslation_02	GIOVANNA PRATI
NoeTranslation_03	GIACOMO IACUMIN
NoeTranslation_04	KENT ROBELLO
NoeTranslation_05	MICHAEL HUSSINGER
NoeTranslation_06	HANNAH SIEBERT
NoeTranslation_07	SEBASTIAN BRÜCK
NoeTranslation_08	JÓNATAN MARCOS MILLÁN
NoeTranslation_09	JOSÉ MANUEL MALAGÓN LEÓN
NoeTranslation_10	CARSTEN HARMANS
NoeTranslation_11	PATRICK KOUDSTAAL
NoeQaCoordination	NOE QA COORDINATION
NoeQaCoordination_00	J. IGNACIO LEÓN LÓPEZ
NoeQaCoordination_01	MATTHEW DAVID JONES
NoeQualityAssurance	NOE QUALITY ASSURANCE
NoeQualityAssurance_00	KEYWORDS STUDIOS
NokLocalizationManagement	NOK LOCALIZATION MANAGEMENT
NokLocalizationManagement_00	KIM DONGYEON
NokTranslation	NOK TRANSLATION
NokTranslation_00	KIM SOONIL
NokQualityAssurance	NOK QUALITY ASSURANCE
NokQualityAssurance_00	SEOUNG KIUNG
NokArtwork	NOK ARTWORK
NokArtwork_00	LEE HOONKYUNG
NhlTranslation	NHL TRANSLATION
NhlTranslation_00	JEANIE HO
NhlTranslation_01	NATALIE YU
NhlQualityAssurance	NHL QUALITY ASSURANCE
NhlQualityAssurance_00	EIJU UMEMURA
NhlQualityAssurance_01	CHIH HSIEN CHIEN
NhlQualityAssurance_02	CHEN WEI MING
NhlArtwork	NHL ARTWORK
NhlArtwork_00	MIKE KAN
IqueLocalizationCoordination	iQue LOCALIZATION COORDINATION
IqueLocalizationCoordination_00	CHEN YIJUN
IqueTranslation	iQue TRANSLATION
IqueTranslation_00	QIU XIAOCHUN
IqueQualityAssurance	iQue QUALITY ASSURANCE
IqueQualityAssurance_00	ZHANG JIONG
SpecialThanks	SPECIAL THANKS
SpecialThanks_00	HARUKA ITOH
SpecialThanks_01	NAHO YOSHIZAWA
SpecialThanks_02	YU KANAI
SpecialThanks_03	TATSUYA KAMIYAMA
SpecialThanks_04	MASAYO NAKAGAMI
SpecialThanks_05	YURINA INOUE
SpecialThanks_06	SHIGENOBU KASAI
SpecialThanks_07	TETSUYA ABE
SpecialThanks_08	TOMOHIRO MINEMURA
SpecialThanks_09	HIROAKI IKARASHI
SpecialThanks_10	SHOHEI TAKAHAMA
SpecialThanks_11	YUMI OSADA
SpecialThanks_12	AKIRA EGUCHI
SpecialThanks_13	NOBUYUKI OKADA
SpecialThanks_14	TADASHI IKEGAMI
SpecialThanks_15	Good-Feel Co., Ltd.
Coordinator	COORDINATOR
Coordinator_00	TOMOKI FUKUSHIMA
ProjectManagement	PROJECT MANAGEMENT
ProjectManagement_00	KAZUYUKI NAKAMURA
ProjectManagement_01	KAORI ISHIZAKI
ProjectManagement_02	SHINYA SAITO
ProjectManagement_03	AKIRA KINASHI
AssociateProducer	ASSOCIATE PRODUCER
AssociateProducer_00	KEI NINOMIYA
LineProducer	LINE PRODUCER
LineProducer_00	YOSHIHIRO NAGATA
Producers	PRODUCERS
Producers_00	TADASHI KAMITAKE
Producers_01	TOYOKAZU NONAKA
GeneralProducers	GENERAL PRODUCERS
GeneralProducers_00	SHIGEFUMI KAWASE
GeneralProducers_01	SHINYA TAKAHASHI
ExecutiveProducer	EXECUTIVE PRODUCER
ExecutiveProducer_00	SHUNTARO FURUKAWA
Copyright	HAL Laboratory, Inc. and Nintendo are\nthe authors of this software for the purpose\nof copyright. All rights reserved.\n©HAL Laboratory, Inc. / Nintendo
$CreditBackGuide	返回
Dialog.msbt
CornerBtn_Back	返回
CornerBtn_Close	关闭
Btn_CancelForExit	取消
Text_FileDeleteConfirm1	要删除所有保存数据吗？
Btn_FileDeleteConfirm1_Yes	删除
Btn_FileDeleteConfirm1_No	不删除
Text_FileDeleteConfirm2	真的要删除吗？
Btn_FileDeleteConfirm2_Yes	真的要删除
Btn_FileDeleteConfirm2_No	还是不删除吧
Text_FileDeleteConfirm3	数据删除后就无法复原了！！\n{color[ff4d2fff]}确定不会后悔吗？{color[000000ff]}
Btn_FileDeleteConfirm3_Yes	不后悔！！！！
Btn_FileDeleteConfirm3_No	不想删除了……
Text_FileDeleteFinished	已删除保存数据。
Title_CpLevel	CP等级
Btn_CpLevelEasy	甜甜
Btn_CpLevelNormal	微辣
Btn_CpLevelHard	中辣
Btn_CpLevelVeryHard	超辣
Text_BattleMenu_ConfirmSessionDisband	要{color[ff4d2fff]}解散{color[000000ff]}团队吗？
Btn_Disband	解散
Text_BattleMenu_NetworkError	发生连接错误。
Text_BattleMenu_NetworkTimeout	由于已经有一段时间没有操作，\n{color[ff4d2fff]}连接已断开。{color[000000ff]}
Text_BattleMenu_FirstNetworkNote	参加线上游玩的话，\n玩家名称会向他人公开。\n\n※对战对手也有可能是电脑。
Text_BattleMenu_NetworkPenalty	上次的线上游玩未能正常结束。\n如果持续地发生连接中断的情况，\n可能会使得积分下降。\n建议在能稳定连接的环境下游玩。
Text_ResultSessionDisbanded	团队已{color[ff4d2fff]}解散{color[000000ff]}。
Text_ColectionSweet_CannotOpen	尚未持有角色点心。\n\n角色点心可以通过玩游戏来获得。
Text_CollectionSweet_AskMode	要装饰蛋糕吗？\n还是要查看角色点心收藏呢？
Btn_View	查看收藏
Btn_Decor	装饰
Text_Retry	要从游戏一开始的地方{color[ff4d2fff]}重试{color[000000ff]}吗？
Btn_Retry	重试
Text_Reset	要将关卡{color[ff4d2fff]}重置{color[000000ff]}为\n最初的状态吗？
Btn_Reset	重置
Text_StageExitSimple	要返回主桌吗？\n\n返回后，已经吃下的草莓\n将{color[ff4d2fff]}不会被加到{color[000000ff]}美食级别。
Text_BackToHome	要返回主桌吗？
Btn_StageExit	返回主桌
Text_BackToTitle	要返回标题吗？
Btn_BackToTitle	返回标题
Btn_PlayAgain	再玩一次
Btn_RuleChange	游玩其他游戏
Btn_SkinChange	更换外表
Btn_BackToHome	返回主桌
Title_Rule	选择规则
Btn_RuleGrandPrix	美食大赏
Btn_RuleRace	单人比赛
Btn_RuleBonusGame	单人小游戏
Btn_RuleFinalBattle	单人生存战
Btn_RuleTraining	自由练习
Text_ControllerErrorShortsge	已连接的\n{color[ff4d2fff]}手柄{color[000000ff]}只有{color[ff4d2fff]}1个{color[000000ff]}。
Text_ControllerErrorDisconnectedP2	要返回主桌吗？\n\n要继续游戏的话，\n需要连接{color[ff4d2fff]}与人数相同数量的手柄{color[000000ff]}。
Btn_ConnectController	继续游戏
Btn_EndGame	返回主桌
Text_ControllerErrorDisconnectedNetwork	手柄的{color[ff4d2fff]}连接已断开{color[000000ff]}。\n将返回主桌。
Text_HomeCreditOrHistory	要查看制作人员名单吗？\n要查看过去的冒险吗？
Btn_Credit	查看制作人员名单
Btn_History	查看过去的冒险
History.msbt
$HistoryCloseInfoText	返回
ProductNameLatest1	星之卡比 探索发现
ProductNameLatest2	星之卡比 新星同盟
ProductNameLatest3	卡比群星战2
ProductNameLatest4	超级卡比猎人队
ProductNameOther1	Kirby's Extra Epic Yarn
ProductNameOther2	Kirby Battle Royale
ProductNameOther3	Kirby's Blowout Blast
ProductNameOther4	Team Kirby Clash Deluxe
ProductNameOther5	Kirby: Planet Robobot
ProductNameOther6	Kirby and the Rainbow Curse
ProductNameOther7	Kirby Fighters Deluxe
ProductNameOther8	Dedede's Drum Dash Deluxe
ProductNameOther9	Kirby: Triple Deluxe
$HistoryTitleText	过去的冒险
PlatformName1	Nintendo Switch
PlatformName2	Nintendo 3DS
PlatformName3	Wii U
ProductCommentLatest1	“星之卡比”系列首次的3D动作游戏。\n使用卡比的崭新能力“塞满嘴变形”和\n“复制能力进化”，在融合了文明与自然的\n未知“新世界”中进行冒险。\n通过分享Joy-Con，最多可以2人一起游玩。
ProductCommentLatest2	以盟友之心让敌人成为同伴！\n与同伴搭档依次使出“盟友能力”，\n为拯救世界而战吧！\n通过分享Joy-Con，最多可以4人一起游玩。
ProductCommentLatest3	选择复制能力，最多4人一起对战的动作游戏。\n玩家也可以游玩故事模式，\n挑战帝帝帝大王与魅塔骑士联手的组合。\n此外，还能够在线上与全世界的玩家以及朋友对战。
ProductCommentLatest4	4种职业的卡比齐心协力挑战各种任务，\n基本免费的动作游戏。\n单人游戏当然不用说，还能用线上游戏、\n分享游玩等方式轻松地进行多人游戏。
ProductCommentOther1	操控毛线外观的卡比，\n使用毛线特有的多种招式进行冒险的动作游戏。\n除了可以让卡比变身成各种样貌的“换形能力”，\n还能够使用全新的“裁缝能力”！
ProductCommentOther2	操控卡比与众多对手\n展开多彩多姿战斗的动作游戏。\n除了可以1个人游玩，也能够通过互联网连接\n或本地联机与最多4名玩家互相竞争！
ProductCommentOther3	《Kirby: Planet Robobot》的小游戏脱胎换骨，\n变成了卷轴式3D动作游戏。\n驰骋在3D空间，凭借吸入与吐出打倒敌人\n并取得高分吧！
ProductCommentOther4	在《Kirby: Planet Robobot》的小游戏中\n加入了新的探索、超过80种的“装备”，\n以及作为据点的“小镇”等等崭新要素。\n还能够享受4人合作游玩的基本免费游戏。
ProductCommentOther5	为了拯救被邪恶企业侵略的世界，\n卡比将与拥有10种以上不同型态的\n“机器博博装甲”一同奋战！\n可对应所有的amiibo。
ProductCommentOther6	使用触控笔画出彩虹线条，\n将卡比引导至终点吧！\n卡比还可以变身成3种不同种类的运输设备。\n还可以由其他玩家操纵瓦豆鲁迪，享受4人合作的乐趣！
ProductCommentOther7	在《Kirby: Triple Deluxe》的小游戏中\n新增了更多要素。\n能够从10种复制能力当中选择喜欢的能力进行对战，\n还可以通过联机4人同乐！
ProductCommentOther8	在《Kirby: Triple Deluxe》的小游戏中\n新增了更多要素。\n配合节奏操作帝帝帝大王，\n使用不同跳跃直奔终点！
ProductCommentOther9	特点是不再局限于左右移动，\n还能在关卡的前后移动。\n除了25种复制能力以外，\n还能够享受“大爆炸吸入”带来的冲击性与乐趣！
Home.msbt
FacilityName_BattleMenu	主菜单
FacilityName_CollectionSkin	更换外表
FacilityName_CollectionSweet	角色点心收藏
FacilityName_TrainingMode	自由练习
FacilityName_Reward	奖励菜单
Tips_RollingSpeed	一口笔记：卡比不停地吃草莓会使身体变得越来越大，滚动的速度也会越来越快。
Tips_HoverTime	一口笔记：卡比不停地吃草莓会使身体变得越来越大，可盘旋的时间也会越来越短。
Tips_Slipstream	一口笔记：靠近滚动者的后方，追赶的速度就会稍稍增加。
Tips_Training0	一口笔记：在“自由练习”中，可以自由地练习、奔跑、玩耍！
Tips_Training1	一口笔记：在“自由练习”中，只要吃下最后面的草莓堆，游戏就会结束。
Tips_Training2	一口笔记：在“自由练习”中，可以和远方的朋友通过暗号配对来游玩。在线上也可以自由地练习！
Tips_Training3	一口笔记：在“自由练习”中，藏有4片过去卡比游戏主题的饼干。把它们找出来吧！
Tips_GrandPrix	一口笔记：在“美食大赏”中，1场游戏中可以游玩比赛、小游戏以及生存战，也可以获得角色点心！
Tips_CopyFood	一口笔记：“复制食物”是可以获得复制食物能力的食物，用来装的箱子则称为“食物箱”。
Tips_Wheel0	一口笔记：发动“车轮”时，只要再次按住{[040a|6100]}并转弯，就可以使出能勾勒出曲线的漂移！
Tips_Wheel1	一口笔记：发动“车轮”时，只要再次按住{[040a|6100]}并转弯就能使出漂移。如果能够保持长时间漂移还能发动漂移加速！
Tips_Stone0	一口笔记：发动“石块”时，若长按{[040a|6100]}再放开的话，就能提高攻击范围！由于这样会延长发动时间，使用起来要多加注意。
Tips_Drill0	一口笔记：发动“钻击”后，像画圆一样圈出圆形的话就能使出地面咚！被击中的对手会头晕目眩。
Tips_HiJump0	一口笔记：发动“跳高”时，长按{[040a|6100]}并推动{[041e|f100]}的话，就可以稍微调整落地的位置。
Tips_Burning0	一口笔记：发动“燃烧”时，只要再次按{[040a|6100]}就会发动燃烧加速！而且可以连续发动。
Tips_Needle0	一口笔记：发动“针”时，只要在发动中长按{[040a|6100]}就会发动能快速突击的刺针冲锋！
Tips_Tornado0	一口笔记：发动“龙卷风”时，只要在发动中再次按{[040a|6100]}，就能使效果范围更广，释放瞬间最大风速！
Tips_Jelly0	一口笔记：发动“果冻”时，按{[040a|6100]}能制造出黏黏果冻作为障碍物妨碍对手行动。
Tips_Jelly1	一口笔记：发动“果冻”时，按{[040a|6100]}制造出越多黏黏果冻，果冻能力的持续时间就会越短。
Tips_HomeTable	一口笔记：摆放在举办游戏的派对会场的桌子叫做“主桌”。装饰风格非常有节日的氛围！
Tips_DreamFork	一口笔记：把卡比变小，并实现其梦想的叉子，听说是叫做“梦想叉子”。
Tips_RewardListBgm	一口笔记：能在“奖励菜单”中选择的BGM，也可以在“主桌”或右侧的“自由练习”播放。
Tips_DreamRestaurant	一口笔记：美食节的会场叫做“梦想餐厅”。这个桌子叫做“主桌”。
Tips_MountainCake	一口笔记：卡比因“梦想叉子”的力量而变小。听说已经实现了吃到像山一样的蛋糕的梦想。
Tips_IcePop	一口笔记：“冰棒”的表面滑滑的。但是变成果冻的话，前进的时候会变得稍微顺利一点。
Tips_FinalBattle	一口笔记：在“生存战”中出现，以卡比为目标的夹子，似乎会被体型大的卡比的魅力所吸引。
Tips_ServerHand	一口笔记：出现在关卡中那只谜一般的“手”叫做“服务生之手”。
Tips_CollectionSkin	一口笔记：在“更换外表”中，只要选择“颜色”就可以化身为符合该颜色的角色。向大家展现出自信的一面吧！
Tips_BonusFruit	一口笔记：吃关卡中的蓝莓、覆盆子和樱桃，会影响结果发表时的奖励。
Tips_LoseStrawberry	一口笔记：按下{[0420|f300]}就可以改变焦距。推荐在拍摄截图时使用。
Tips_AddedTipes00	一口笔记：按下{[0419|a000]}中的任意一个键，就可以利用表情符号进行简单的交流。
Tips_AddedTipes01	一口笔记：在线上或是本地联机时，按下{[0419|a000]}，就可以发送4种不同的固定句子。
Tips_AddedTipes02	一口笔记：即使在游戏中的结果发表等界面，只要按下{[0419|a000]}就能让卡比使用表情符号表现自己哦！
Tips_AddedTipes03	一口笔记：装饰在蛋糕最上方的点心也会被放在比赛的起点。
Tips_AddedTipes04	一口笔记：比赛时经常会遇到有裂痕的饼干墙，这时如果是处在“果冻”的状态下就能轻松通过！
Tips_AddedTipes05	一口笔记：角色点心一共有256个！收集到的角色点心也会被装饰在“自由练习”中。
Tips_AddedTipes06	一口笔记：“自由练习”就是自由地玩耍。因此，即便吃了草莓，也不会影响美食级别。
Tips_AddedTipes07	一口笔记：在线上与大家一起游玩的话，美食级别会比较容易提升。
Tips_AddedTipes08	一口笔记：“超辣”这种高CP等级虽然难度较高，但能够得到美食级别奖励。先在“微辣”之类的等级练习后再去挑战吧！
Tips_AddedTipes09	一口笔记：游玩过《星之卡比 探索发现》或《卡比群星战2》的玩家，会各得到3首比赛BGM的赠礼！
Tips_AddedTipes10	一口笔记：游玩过《星之卡比 新星同盟》或《超级卡比猎人队》的玩家，会各得到3首比赛BGM的赠礼！
Tips_AddedTipes11	一口笔记：在“角色点心收藏”查看收藏时，可以旋转该收藏查看其背面。只有金太郎糖的两面都采用了同样的设计！
Tips_AddedTipes12	一口笔记：在“角色点心收藏”查看收藏时，按下{[0420|f300]}就可以稍稍调整焦距。
Tips_AddedTipes13	一口笔记：除了线上游玩，只要按住{[0403|0300]}并开始游玩大赏或单人比赛，就能播放在奖励菜单中选择的比赛BGM。
Tips_AddedTipes14	一口笔记：如果一直赢不了，就将CP等级调为“甜甜”或“微辣”来练习一下吧。一样可以获得美食点数哦！
Tips_AddedTipes15	一口笔记：只要游玩美食大赏、单人比赛以及单人生存战就一定可以获得“角色点心”。如果在美食大赏中以“中辣”以上的CP等级进行游玩的话，能够一次获得2个！
Tips_AddedTipes16	一口笔记：只要在线上的美食大赏中取得第1名，就能再多获得1个“角色点心”。同时获得2个以上的“角色点心”时，必定有1个是之前没有获得过的点心。
Lobby.msbt
$LobbyMatching	正在配对……
$LobbyMatchingDone	配对完成
$LobbyMainQuit	离开大厅
Pause.msbt
ContinueBtnText	继续游戏
RetryBtnText	重试
ResetBtnText	重置
BackBtnText_ToHome	返回主桌
BackBtnText_ToTitle	返回标题
HowToBtnText	游戏说明
Resident.msbt
$Saving	正在保存
Result.msbt
$ResultText	结果发表
ResultRankText_00	获胜！
ResultRankText_01	第2名
ResultRankText_02	第3名
ResultRankText_03	第4名
ResultKeepWiningText	{[0301|0000]}{size[4b00]}连胜{size[6400]}
ResultBonusText_Online	线上奖励
ResultBonusText_DifficultyLevelHard	中辣奖励
ResultBonusText_DifficultyLevelVeryHard	超辣奖励
ResultBonusText_GrandPrix	大赏奖励
ResultOnlineBonus_NumText	× {[0302|0000]}
$RewardGetTodaysSweet	随兴 角色点心奖励
AnnounceText_Victory	获胜的是……
BonusName_EatScoreFoodInBonusRule	在小游戏中吃了最多草莓
BonusName_EatScoreFoodInRaceRule	在比赛中吃了最多草莓
BonusName_EatStrawberry5	在比赛中吃了5个草莓
BonusName_EatBonusFruit_Blueberry	吃了最多蓝莓
BonusName_EatBonusFruit_Cherry	吃了最多樱桃
BonusName_EatBonusFruit_Raspberry	吃了最多覆盆子
BonusName_DamageBreakableBlock	撞到最多破碎饼干
BonusName_UseCopyAbility	使用复制食物的能力次数最多
BonusName_DefeatEnemy	打倒最多敌人角色
BonusName_UseHoverTime	使用盘旋的次数最多
$LayoutResultBonusPointPlus	+
$ResultBonusPointPlayerNone	没有人
RewardGet_GetText	获得了{[030b]}\n{color[ff4d2fff]}{[030a]}{color[000000ff]}！
RewardGet_GetStageText_Bonus	可以在小游戏中游玩\n{color[ff4d2fff]}{[030a]}\n{color[000000ff]}关卡了！
RewardGet_GetStageText_Race	可以在比赛中游玩\n{color[ff4d2fff]}{[030a]}\n{color[000000ff]}关卡了！
RewardGet_GetStageText_Final	可以在生存战中游玩\n{color[ff4d2fff]}{[030a]}\n{color[000000ff]}关卡了！
RewardGet_GetSoundText_Race	可以在比赛中播放\n比赛BGM\n{color[ff4d2fff]}{[030a]}{color[000000ff]}了！
RewardGet_SpecialRewardText_PlayedDiscovery_0	感谢游玩\n{color[ff4d2fff]}《星之卡比 探索发现》{color[000000ff]}！
RewardGet_SpecialRewardText_PlayedDiscovery_1	作为游玩特典，\n{color[ff4d2fff]}3首《星之卡比 探索发现》{color[000000ff]}的{color[ff4d2fff]}BGM{color[000000ff]}\n现在可以在比赛中播放了！
RewardGet_SpecialRewardText_PlayedStarAllies_0	感谢游玩\n{color[ff4d2fff]}《星之卡比 新星同盟》{color[000000ff]}！
RewardGet_SpecialRewardText_PlayedStarAllies_1	作为游玩特典，\n{color[ff4d2fff]}3首《星之卡比 新星同盟》{color[000000ff]}的{color[ff4d2fff]}BGM{color[000000ff]}\n现在可以在比赛中播放了！
RewardGet_SpecialRewardText_PlayedKirbyFighters2_0	感谢游玩\n{color[ff4d2fff]}《卡比群星战2》{color[000000ff]}！
RewardGet_SpecialRewardText_PlayedKirbyFighters2_1	作为游玩特典，\n{color[ff4d2fff]}3首《卡比群星战2》{color[000000ff]}的{color[ff4d2fff]}BGM{color[000000ff]}\n现在可以在比赛中播放了！
RewardGet_SpecialRewardText_PlayedSuperKirbyHunters_0	感谢游玩\n{color[ff4d2fff]}《超级卡比猎人队》{color[000000ff]}！
RewardGet_SpecialRewardText_PlayedSuperKirbyHunters_1	作为游玩特典，\n{color[ff4d2fff]}3首《超级卡比猎人队》{color[000000ff]}的{color[ff4d2fff]}BGM{color[000000ff]}\n现在可以在比赛中播放了！
RewardGet_SpecialRewardText_CompleteAllCollectionSweet_0	完成\n角色点心收藏了！
RewardGet_SpecialRewardText_CompleteAllCollectionSweet_1	作为奖励，\n可以在角色点心收藏中播放BGM\n{color[ff4d2fff]}{[030a]}{color[000000ff]}了！
RewardGet_SpecialRewardText_HitMaxGourmetRank_0	美食级别达到MAX了！
RewardGet_SpecialRewardText_HitMaxGourmetRank_1	作为奖励，\n可以在主桌中播放BGM\n{color[ff4d2fff]}{[030a]}{color[000000ff]}了！
RewardList.msbt
Category_Unrevealed	???
Name_Unrevealed	???
Description	美食级别达到{[0301|0000]}\n就会开放！
$RewardListTitle	奖励菜单
Step.msbt
$StepStageTodayMenu	今天的关卡菜单
StepStageTodayMenu_Single	今天的菜单
$TodayMainDish	主餐
$StepStageRule	规则
StepStageRuleText_DecisiveBattle	主餐\n美食生存战！
StepStageRuleText_GoalFruit	以草莓堆为目标吧。
StepStageRuleText_DropScoreItem	吃下掉下来的草莓吧。
StepStageRuleText_TeaCupItem	滚入杯中，然后吃下草莓吧。
StepStageRuleText_BattleEnemy	打倒敌人后吃下草莓吧。
StepStageRuleText_BreakBox	破坏箱子后吃下草莓吧。
$StepScaleMaterSizeUp	尺寸增加
$StepScaleMaterSizeUpMax	达到最大尺寸！
StepHowToPlayText_00	吃东西、滚动，然后变大吧！
StepHowToPlayTextSub_00	身体变得越大，滚动得越快。身体最大的那位，就是获胜者！
StepHowToPlayText_01	就算掉下去了，也能按{[0400|0000]}再次飞起来。
StepHowToPlayTextSub_01	身体越小，就能凭借盘旋飞得越久，也就越有优势。
StepHowToPlayText_02	终点的草莓一人只能吃一盘！
StepHowToPlayTextSub_02	在大赏中，当3个人把这些草莓全部吃完之后就会进入下一个游戏。
StepHowToPlayText_03	按下{[040a|6100]}使用复制食物，逆转形势！
StepHowToPlayTextSub_03	一口气让巨大的对手掉下去，抢夺草莓吧！
$StepStartSignGoText	LET'S EAT！
TimeupText_Finish	多谢款待
$StepKillLogText	被你打倒了
$StepKillLogPlus	+
$StepKillerInfoText	把你打倒了
$StepAchievementMinus	-
$StepDropoutRouletteStart	轮盘
$MainTrainingBaseReset	重置吃完的草莓
$MainTrainingGuideText	－吃掉草莓堆之后，游戏就会结束－
TitleMenu.msbt
$TiteleMenuBtn	按下{[0400|0000]}键
$TitleMenuCopyright	©HAL Laboratory, Inc. / Nintendo
Version	Ver. {[0301|0000]}.{[0301|0100]}.{[0301|0200]}
$TitleDeleteSaveDataGuide	删除保存数据
Name\AbilityName.msbt
Burning	燃烧
Needle	针
Stone	石块
Drill	钻击
Tornado	龙卷风
Jelly	果冻
HiJump	跳高
Wheel	车轮
InvincibleCandy	彩虹棒棒糖
Name\CollectionCategoryName.msbt
Collection_Category_Sweet	角色点心
Collection_Category_Skin	外表
Collection_Category_Color	颜色
Collection_Category_Sound_Home	主BGM
Collection_Category_Sound_Race	比赛BGM
Collection_Category_Sound_Menu	菜单BGM
Collection_Category_Stage_Race	比赛
Collection_Category_Stage_Bonus	小游戏
Collection_Category_Stage_Final	生存战
Name\ColorName.msbt
Collection_Color_BasicPink	卡比粉红色
Collection_Color_BasicYellow	奇比黄色
Collection_Color_BasicBlue	冰蓝色
Collection_Color_BasicGreen	草饼绿色
Collection_Color_BasicRed	火红色
Collection_Color_Cherry	樱桃色
Collection_Color_Chocolate	巧克力色
Collection_Color_Chocomint	薄荷巧克力色
Collection_Color_Citrus	柑橘色
Collection_Color_Grape	葡萄色
Collection_Color_Orange	橘色
Collection_Color_Pumpkin	南瓜色
Collection_Color_Strawberry	草莓色
Collection_Color_Waddledee	迪橘色
Collection_Color_Dedede	帝帝帝蓝色
Collection_Color_Metaknight	魅塔海军蓝色
Collection_Color_Kawasaki	川崎日落色
Collection_Color_Marx	魔噜酷紫丁香色
Collection_Color_Gooey	蛊依钴蓝色
Collection_Color_Chuchu	啾啾粉红玫瑰色
Collection_Color_Adeleine	阿朵肤橘色
Collection_Color_Daroach	怪盗洛切鼠灰色
Collection_Color_Magolor	魔法洛亚琥珀色
Collection_Color_Taranza	塔狼蛛栗子色
Collection_Color_Susie	苏姿粉红白色
Collection_Color_Francisca	基斯冬蓝色
Collection_Color_Flamberge	露啾绯红色
Collection_Color_Zan	帕噜金光闪闪色
Collection_Color_Elfilin	艾菲灵孔雀色
Collection_Color_Morphoknight	冥蝶灰色
Collection_Color_Burger	汉堡棕色
Collection_Color_Waddledoo	鲁笃番茄酱色
Collection_Color_Retro	复古色调
Collection_Color_Shadow	暗影色
Collection_Color_Carmouth	兜风天空色
Collection_Color_Coo	空紫色
Collection_Color_Kine	海恩水蓝色
Collection_Color_Pudding	布丁色
Collection_Color_Rick	陆库奶油色
Collection_Color_Kiwi	奇异果色
Name\DifficultyName.msbt
Easy	甜甜
Normal	微辣
Hard	中辣
VeryHard	超辣
Name\ItemName.msbt
Strawberry3	3个草莓
Strawberry5	5个草莓
Strawberry10	10个草莓
Name\PlayerName.msbt
Mob_0	Waddelaney
Mob_1	Waddelia
Mob_2	Waddle Waddle
Mob_3	Waddlini
Mob_4	Woddball
Mob_5	Mr. Waddle Waddle
Mob_6	Wadana Dee
Mob_7	Waddlecia
Mob_8	Waddolor
Mob_9	Waddby
Mob_10	Wadda Knight
Mob_11	King WaDeDe
Guest_0	Guest
Cp_0	CP1
Cp_1	CP2
Cp_2	CP3
Bot_0	Pink-Puff
Bot_1	PinkBowler
Bot_2	Puffball
Bot_3	Stubby
Bot_4	Kirby-chan
Bot_5	Kirby-san
Bot_6	PINKball
Bot_7	PeachArmor
Bot_8	Round Hero
Bot_9	Star Hero
Bot_10	Maxim #1
Bot_11	Maxim86
Bot_12	PoweredUp
Bot_13	FullEnergy
Bot_14	VincyCandy
Bot_15	Lickety
Bot_16	Got_a_1UP
Bot_17	0LivesLeft
Bot_18	PointStars
Bot_19	Pink Stars
Bot_20	Twinkles
Bot_21	Glimmer
Bot_22	TheStarRod
Bot_23	MrNightmare
Bot_24	RnbwIsland
Bot_25	RainboSord
Bot_26	EasyBreezy
Bot_27	DreamRacer
Bot_28	YourBuddy
Bot_29	Animal Pal
Bot_30	FromRipple
Bot_31	FactoryFoe
Bot_32	GoGoKirby
Bot_33	Yo_Tornado
Bot_34	KirbyPhone
Bot_35	MirageNite
Bot_36	DededeSoul
Bot_37	MaskedMarx
Bot_38	UrOverlord
Bot_39	Crafty Egg
Bot_40	Q.Joronia
Bot_41	SkyPeople
Bot_42	Patrya
Bot_43	P.Haltmann
Bot_44	HeartFwend
Bot_45	ZanParWho?
Bot_46	Neichel
Bot_47	BeastPack
Bot_48	TeaCup
Bot_49	JiroJiro
Bot_50	Minigamer
Bot_51	Shirleelee
Bot_52	Anna
Bot_53	Yetta
Bot_54	Wisdom
Bot_55	Amy
Bot_56	Otto
Bot_57	Kyle
Bot_58	Kiddo
Bot_59	Cook
Bot_60	Katie
Bot_61	Coleman
Bot_62	Samuel
Bot_63	Sylvaria
Bot_64	Suzanna
Bot_65	Sebastian
Bot_66	Sophie
Bot_67	Tyler
Bot_68	Chelsea
Bot_69	Dreamstalk
Bot_70	Tina
Bot_71	Thomas
Bot_72	Nyaoko
Bot_73	Nikita
Bot_74	Nurmela
Bot_75	Nedry
Bot_76	Nordin
Bot_77	Ricky
Bot_78	Fedor
Bot_79	Fauser
Bot_80	Herrlich
Bot_81	Hopkins
Bot_82	Maggie
Bot_83	Mitchel
Bot_84	Moore
Bot_85	Melanie
Bot_86	Monika
Bot_87	Janice
Bot_88	Julian
Bot_89	Johan
Bot_90	Lionel
Bot_91	Ricardo
Bot_92	Luisa
Bot_93	Leon
Bot_94	Roxanne
Bot_95	WhySoWise
Bot_96	Springer
Bot_97	Summers
Bot_98	Autumn
Bot_99	Winterly
Bot_100	DrumDasher
Bot_101	LoLoLaLa
Bot_102	KingKracko
Bot_103	TheBright1
Bot_104	RoRoRoller
Bot_105	Sr.Heavy
Bot_106	Meta.G.
Bot_107	IceLizard
Bot_108	MaxSpeed
Bot_109	LiteMatter
Bot_110	MskdWhspy
Bot_111	DynaWings
Bot_112	BamWhammy
Bot_113	Jr.Heavy
Bot_114	HeyHowdyHi
Bot_115	PonCon
Bot_116	Ado-chan
Bot_117	ZeroOne
Bot_118	EyeBelly
Bot_119	Magmister
Bot_120	VibrantPix
Bot_121	HeavyIII
Bot_122	Zero2sOwie
Bot_123	NightMareS
Bot_124	Knightmare
Bot_125	Elephanphan
Bot_126	GippiG
Bot_127	Titan Arm
Bot_128	QuestnMark
Bot_129	BatafireBB
Bot_130	Gobbler
Bot_131	Drawcian
Bot_132	Paint_Soul
Bot_133	CacklinPnt
Bot_134	UnknownArt
Bot_135	MouseMob
Bot_136	SneakSnack
Bot_137	CakeTaker
Bot_138	Neb-u-la
Bot_139	Galaxys#1
Bot_140	BoomKapow
Bot_141	WhoaKabula
Bot_142	SoulScream
Bot_143	Kindolor
Bot_144	Adorabolor
Bot_145	Sweetolor
Bot_146	Troubolor
Bot_147	ThankYou
Bot_148	YourServer
Bot_149	Lil_Landia
Bot_150	TunaBlade
Bot_151	TaranzaFan
Bot_152	DreamBloom
Bot_153	FatalBloom
Bot_154	Miracle4
Bot_155	LastLander
Bot_156	BringItOn
Bot_157	Kirbistory
Bot_158	HeartStar
Bot_159	SusieSuit
Bot_160	Haltmann$
Bot_161	Star_Dream
Bot_162	Nyaooon!
Bot_163	MageSister
Bot_164	ShakenSoda
Bot_165	BigBigBBQ
Bot_166	DrumNWaste
Bot_167	Bonjam
Bot_168	Jambuhbye
Bot_169	Voidalike
Bot_170	Carol
Bot_171	Leongar
Bot_172	FlutterBy
Bot_173	HeyWhatHuh
Bot_174	ID-F85
Bot_175	Psychmedlr
Bot_176	BandanaRun
Bot_177	HeartDrive
Bot_178	MeowMeow
Bot_179	New World
Name\SeriesName.msbt
Series0	Kirby's Dream Land
Series1	Kirby's Adventure
Series2	Kirby's Pinball Land
Series3	Kirby's Dream Course
Series4	Kirby's Dream Land 2
Series5	Kirby's Block Ball
Series6	Kirby Super Star
Series7	Kirby's Star Stacker
Series8	Kirby's Dream Land 3
Series9	Kirby's Star Stacker (Super Famicom)
Series10	Kirby 64: The Crystal Shards
Series11	Kirby Tilt 'n' Tumble
Series12	Kirby: Nightmare in Dream Land
Series13	Kirby Air Ride
Series14	Kirby & The Amazing Mirror
Series15	Kirby: Canvas Curse
Series16	Kirby: Squeak Squad
Series17	Kirby Super Star Ultra
Series18	Kirby's Epic Yarn
Series19	Kirby Mass Attack
Series20	Kirby's Return to Dream Land
Series21	Kirby's Dream Collection Special Edition
Series22	Kirby: Triple Deluxe
Series23	Kirby Fighters Deluxe
Series24	Dedede's Drum Dash Deluxe
Series25	Kirby and the Rainbow Curse
Series26	Kirby: Planet Robobot
Series27	Team Kirby Clash Deluxe
Series28	Kirby's Blowout Blast
Series29	Kirby Battle Royale
Series30	星之卡比 新星同盟
Series31	Kirby's Extra Epic Yarn
Series32	超级卡比猎人队
Series33	卡比群星战2
Series34	星之卡比 探索发现
Series35	Kirby 30th Music Fest
Series36	Kirby Café
Series37	Kirby 30th Anniversary
Name\SkinName.msbt
Collection_Skin_None	普通
Collection_Skin_WaddleDee	头巾瓦豆鲁迪
Collection_Skin_Dedede	帝帝帝大王
Collection_Skin_Metaknight	魅塔骑士
Collection_Skin_Kawasaki	厨师川崎
Collection_Skin_Marx	魔噜酷
Collection_Skin_Gooey	蛊依
Collection_Skin_Chuchu	啾啾
Collection_Skin_Adeleine	阿朵莱妮&莉宝
Collection_Skin_Daroach	怪盗洛切
Collection_Skin_Magolor	魔法洛亚
Collection_Skin_Taranza	塔狼蛛
Collection_Skin_Susie	秘书苏姿
Collection_Skin_Francisca	冰斧基斯
Collection_Skin_Flamberge	炎剑露啾
Collection_Skin_Zan	雷枪帕噜提扎努
Collection_Skin_Elfilin	艾菲灵
Collection_Skin_MorphoKnight	冥蝶骑士
Collection_Skin_Burger	卡比汉堡
Collection_Skin_WaddleDoo	瓦豆鲁笃
Collection_Skin_Cream	鲜奶油
Collection_Skin_Kine	海恩
Collection_Skin_CarMouth	汽车塞满嘴蛋糕
Collection_Skin_Coo	空
Collection_Skin_Rick	陆库
Name\SoundName.msbt
Collection_Sound_Home	Kirby's Dream Buffet
Collection_Sound_RewardRace0	I'm Hungry Pinker Ball!
Collection_Sound_RewardRace1	Youth Athletic Meet!
Collection_Sound_RewardRace2	Colorful Cute Candies
Collection_Sound_RewardRace3	Fun Drive with You
Collection_Sound_RewardRace4	Caramel Country Western
Collection_Sound_RewardRace5	Jazz Band of Four Balls
Collection_Sound_RewardRace6	Winter Days Route 8
Collection_Sound_RewardRace7	Love Love Alivel
Collection_Sound_RewardRace8	Seven-Colored Sky
Collection_Sound_RewardRace9	Dance with Painting Witch
Collection_Sound_RewardRace10	Revenge of Steel Wings
Collection_Sound_RewardRace11	Flying in the Clouds
Collection_Sound_RewardRace12	Colorful Pinball
Collection_Sound_RewardRace13	Polka Dot Cityscape
Collection_Sound_RewardRace14	Tonight's Light Up Show
Collection_Sound_RewardRace15	I'm Hungry Pinker Ball! Ver. 2
Collection_Sound_MemorialTrack0	Kirby's Dream Land：纪念乐曲1
Collection_Sound_MemorialTrack1	Kirby's Dream Land：纪念乐曲2
Collection_Sound_MemorialTrack2	Kirby's Adventure：纪念乐曲1
Collection_Sound_MemorialTrack3	Kirby's Adventure：纪念乐曲2
Collection_Sound_MemorialTrack4	Kirby's Pinball Land：纪念乐曲1
Collection_Sound_MemorialTrack5	Kirby's Pinball Land：纪念乐曲2
Collection_Sound_MemorialTrack6	Kirby's Dream Course：纪念乐曲1
Collection_Sound_MemorialTrack7	Kirby's Dream Course：纪念乐曲2
Collection_Sound_MemorialTrack8	Kirby's Dream Land 2：纪念乐曲1
Collection_Sound_MemorialTrack9	Kirby's Dream Land 2：纪念乐曲2
Collection_Sound_MemorialTrack10	Kirby's Block Ball：纪念乐曲1
Collection_Sound_MemorialTrack11	Kirby's Block Ball：纪念乐曲2
Collection_Sound_MemorialTrack12	Kirby Super Star：纪念乐曲1
Collection_Sound_MemorialTrack13	Kirby Super Star：纪念乐曲2
Collection_Sound_MemorialTrack14	Kirby Super Star：纪念乐曲3
Collection_Sound_MemorialTrack15	Kirby's Dream Land 3：纪念乐曲1
Collection_Sound_MemorialTrack16	Kirby's Dream Land 3：纪念乐曲2
Collection_Sound_MemorialTrack17	Kirby 64: The Crystal Shards：纪念乐曲1
Collection_Sound_MemorialTrack18	Kirby 64: The Crystal Shards：纪念乐曲2
Collection_Sound_MemorialTrack19	Kirby Tilt 'n' Tumble：纪念乐曲1
Collection_Sound_MemorialTrack20	Kirby Tilt 'n' Tumble：纪念乐曲2
Collection_Sound_MemorialTrack21	Kirby: Nightmare in Dream Land：纪念乐曲1
Collection_Sound_MemorialTrack22	Kirby: Nightmare in Dream Land：纪念乐曲2
Collection_Sound_MemorialTrack23	Kirby Air Ride：纪念乐曲1
Collection_Sound_MemorialTrack24	Kirby Air Ride：纪念乐曲2
Collection_Sound_MemorialTrack25	Kirby Air Ride：纪念乐曲3
Collection_Sound_MemorialTrack26	Kirby & The Amazing Mirror：纪念乐曲1
Collection_Sound_MemorialTrack27	Kirby & The Amazing Mirror：纪念乐曲2
Collection_Sound_MemorialTrack28	Kirby: Squeak Squad：纪念乐曲1
Collection_Sound_MemorialTrack29	Kirby: Squeak Squad：纪念乐曲2
Collection_Sound_MemorialTrack30	Kirby Super Star Ultra：纪念乐曲1
Collection_Sound_MemorialTrack31	Kirby Super Star Ultra：纪念乐曲2
Collection_Sound_MemorialTrack32	Kirby's Return to Dream Land：纪念乐曲1
Collection_Sound_MemorialTrack33	Kirby's Return to Dream Land：纪念乐曲2
Collection_Sound_MemorialTrack34	Kirby's Return to Dream Land：纪念乐曲3
Collection_Sound_MemorialTrack35	Kirby's Dream Collection：纪念乐曲1
Collection_Sound_MemorialTrack36	Kirby's Dream Collection：纪念乐曲2
Collection_Sound_MemorialTrack37	Kirby: Triple Deluxe：纪念乐曲1
Collection_Sound_MemorialTrack38	Kirby: Triple Deluxe：纪念乐曲2
Collection_Sound_MemorialTrack39	Kirby: Planet Robobot：纪念乐曲1
Collection_Sound_MemorialTrack40	Kirby: Planet Robobot：纪念乐曲2
Collection_Sound_MemorialTrack41	新星同盟：纪念乐曲1
Collection_Sound_MemorialTrack42	新星同盟：纪念乐曲2
Collection_Sound_MemorialTrack43	新星同盟：纪念乐曲3
Collection_Sound_MemorialTrack44	超级卡比猎人队：纪念乐曲1
Collection_Sound_MemorialTrack45	超级卡比猎人队：纪念乐曲2
Collection_Sound_MemorialTrack46	卡比群星战2：纪念乐曲1
Collection_Sound_MemorialTrack47	卡比群星战2：纪念乐曲2
Collection_Sound_MemorialTrack48	探索发现：纪念乐曲1
Collection_Sound_MemorialTrack49	探索发现：纪念乐曲2
Collection_Sound_MemorialTrack50	探索发现：纪念乐曲3
Collection_Sound_MemorialTrack51	探索发现：纪念乐曲4
Collection_Sound_MemorialTrack52	探索发现：纪念乐曲5
Collection_Sound_MemorialTrack53	Kirby 30th Music Fest：HAL Laboratory梦想乐队乐曲
Collection_Sound_MemorialTrack54	探索发现：游玩特典乐曲1
Collection_Sound_MemorialTrack55	探索发现：游玩特典乐曲2
Collection_Sound_MemorialTrack56	探索发现：游玩特典乐曲3
Collection_Sound_MemorialTrack57	新星同盟：游玩特典乐曲1
Collection_Sound_MemorialTrack58	新星同盟：游玩特典乐曲2
Collection_Sound_MemorialTrack59	新星同盟：游玩特典乐曲3
Collection_Sound_MemorialTrack60	卡比群星战2：游玩特典乐曲1
Collection_Sound_MemorialTrack61	卡比群星战2：游玩特典乐曲2
Collection_Sound_MemorialTrack62	卡比群星战2：游玩特典乐曲3
Collection_Sound_MemorialTrack63	超级卡比猎人队：游玩特典乐曲1
Collection_Sound_MemorialTrack64	超级卡比猎人队：游玩特典乐曲2
Collection_Sound_MemorialTrack65	超级卡比猎人队：游玩特典乐曲3
Collection_Sound_CollectionSweetComplete	Kirby's Ultra Gourmet Memories
Collection_Sound_HomeMaxRank	Elegant Afternoon Tea Time
Name\StageName.msbt
Race1RollcakeMap01	蛋糕卷
Race1RollcakeMap02	蛋糕卷
Race2RollcakeMap01	蛋糕卷
Race2RollcakeMap02	蛋糕卷
Race1BaumkuchenMap01	年轮蛋糕
Race1BaumkuchenMap02	年轮蛋糕
Race2BaumkuchenMap01	年轮蛋糕
Race2BaumkuchenMap02	年轮蛋糕
Race1ShortCakeMap01	草莓蛋糕
Race1ShortCakeMap02	草莓蛋糕
Race2ShortCakeMap01	草莓蛋糕
Race2ShortCakeMap02	草莓蛋糕
Race1PancakeMap01	美式松饼
Race1PancakeMap02	美式松饼
Race2PancakeMap01	美式松饼
Race2PancakeMap02	美式松饼
Race1ChocolateFountainMap01	巧克力喷泉
Race1ChocolateFountainMap02	巧克力喷泉
Race2ChocolateFountainMap01	巧克力喷泉
Race2ChocolateFountainMap02	巧克力喷泉
Race1IceCreamMap01	雪糕
Race1IceCreamMap02	雪糕
Race2IceCreamMap01	雪糕
Race2IceCreamMap02	雪糕
Race1HamburgerMap01	汉堡
Race1HamburgerMap02	汉堡
Race2HamburgerMap01	汉堡
Race2HamburgerMap02	汉堡
Race1DonutMap01	甜甜圈
Race1DonutMap02	甜甜圈
Race2DonutMap01	甜甜圈
Race2DonutMap02	甜甜圈
BonusGame_BattleCupcakeMap01	杯子蛋糕
BonusGame_BattleCupcakeMap02	杯子蛋糕
BonusGame_BattleCupcakeMap03	杯子蛋糕
BonusGame_BattleCheeseFondueMap01	起司锅
BonusGame_BattleCheeseFondueMap02	起司锅
BonusGame_BattleCheeseFondueMap03	起司锅
BonusGame_BattleElfilinMap01	艾菲灵蛋糕
BonusGame_BattleKirbyMap01	卡比蛋糕
BonusGame_BattlePieMap01	甜派
BonusGame_BattlePieMap02	甜派
BonusGame_BattlePieMap03	甜派
BonusGame_BattleWaffleMap01	格子松饼
BonusGame_BattleWaffleMap02	格子松饼
BonusGame_BoxCupcakeMap01	杯子蛋糕
BonusGame_BoxCupcakeMap02	杯子蛋糕
BonusGame_BoxCupcakeMap03	杯子蛋糕
BonusGame_BoxPieMap01	甜派
BonusGame_BoxPieMap02	甜派
BonusGame_BoxPieMap03	甜派
BonusGame_BoxWaffleMap01	格子松饼
BonusGame_BoxWaffleMap02	格子松饼
BonusGame_DropCupcakeMap01	杯子蛋糕
BonusGame_DropCupcakeMap02	杯子蛋糕
BonusGame_DropCupcakeMap03	杯子蛋糕
BonusGame_DropChiffonCakeMap01	戚风蛋糕
BonusGame_DropChiffonCakeMap02	戚风蛋糕
BonusGame_DropChiffonCakeMap03	戚风蛋糕
BonusGame_DropKirbyMap01	卡比蛋糕
BonusGame_DropElfilinMap01	艾菲灵蛋糕
BonusGame_DropPieMap01	甜派
BonusGame_DropPieMap02	甜派
BonusGame_DropPieMap03	甜派
BonusGame_DropCheeseFondueMap01	起司锅
BonusGame_DropCheeseFondueMap02	起司锅
BonusGame_DropCheeseFondueMap03	起司锅
BonusGame_DropWaffleMap01	格子松饼
BonusGame_DropWaffleMap02	格子松饼
BonusGame_CupTeaCupMap01	喝茶时光
BonusGame_CupTeaCupMap02	喝茶时光
FinalBattleWholecakeMap01	圆形蛋糕
FinalBattleWholecakeMap02	圆形蛋糕
FinalBattleWholecakeMap03	圆形蛋糕
FinalBattleSquarecakeMap01	方形蛋糕
FinalBattleSquarecakeMap02	方形蛋糕
FinalBattleSquarecakeMap03	方形蛋糕
FinalBattleIcePopMap01	冰棒
FinalBattleIcePopMap02	冰棒
FinalBattleIcePopMap03	冰棒
FinalBattlePuddingMap01	布丁圣代
FinalBattlePuddingMap02	布丁圣代
FinalBattlePuddingMap03	布丁圣代
FinalBattleHamburgerSteakMap01	烧烤
FinalBattleHamburgerSteakMap02	烧烤
FinalBattleHamburgerSteakMap03	烧烤
FinalBattleSandwichMap01	三明治
FinalBattleSandwichMap02	三明治
FinalBattleSandwichMap03	三明治
FinalBattleMagolorMap01	魔法洛亚蛋糕
FinalBattleWhispyWoodsMap01	风语关卡蛋糕
Collection_Stage_IceCream	雪糕
Collection_Stage_ChocolateFountain	巧克力喷泉
Collection_Stage_Magolor	魔法洛亚蛋糕
Collection_Stage_Elfilin	艾菲灵蛋糕
Collection_Stage_IcePop	冰棒
Collection_Stage_HamburgerSteak	烧烤
Collection_Stage_Kirby	卡比蛋糕
Collection_Stage_WhispyWoods	风语关卡蛋糕
Name\SweetName.msbt
Collection_Sweet_Kirby	卡比
Collection_Sweet_Dedede	帝帝帝大王
Collection_Sweet_WaddleDee	瓦豆鲁迪
Collection_Sweet_WaddleDoo	瓦豆鲁笃
Collection_Sweet_Kracko	独眼云
Collection_Sweet_WhispyWoods	风语大树
Collection_Sweet_KirbyPixel	卡比点阵
Collection_Sweet_WarpStar	传送之星点阵
Collection_Sweet_WaddleDeePixel	瓦豆鲁迪点阵
Collection_Sweet_BrontoburtPixel	飞翅球球点阵
Collection_Sweet_Grizzo	头带熊点阵
Collection_Sweet_DededePixel	帝帝帝大王点阵
Collection_Sweet_DededeShocked	帝帝帝大王点阵（惊吓）
Collection_Sweet_MintLeaf	薄荷叶点阵
Collection_Sweet_SuperspicyCurry	超辣咖喱饭点阵
Collection_Sweet_StarRod	卡比（星星神杖）
Collection_Sweet_Ufo	UFO卡比
Collection_Sweet_MrShine	闪亮先生
Collection_Sweet_MrBright	光亮先生
Collection_Sweet_SwordKnight	利剑骑士
Collection_Sweet_Nightmare	梦魇 巫师
Collection_Sweet_Metaknight	魅塔骑士
Collection_Sweet_KirbyCannon	卡比点阵（大炮）
Collection_Sweet_KirbySword	利剑卡比点阵
Collection_Sweet_KirbyStone	石块卡比点阵
Collection_Sweet_WaddleDooPixel	瓦豆鲁笃点阵
Collection_Sweet_HotHead	炽热头点阵
Collection_Sweet_Bonkers	锤星猩点阵
Collection_Sweet_KrackoPixel	独眼云点阵
Collection_Sweet_MetaknightPixel	魅塔骑士点阵
Collection_Sweet_Pinball	卡比（蛙鞋）
Collection_Sweet_PinballIcon1	Kirby's Pinball Land (1)
Collection_Sweet_PinballIcon2	Kirby's Pinball Land (2)
Collection_Sweet_DreamCourse	卡比&奇比
Collection_Sweet_KirbyFlag	卡比（旗子）
Collection_Sweet_DreamCourseLogo	卡比（一杆进洞）
Collection_Sweet_Rick	陆库
Collection_Sweet_Kine	海恩
Collection_Sweet_Coo	空
Collection_Sweet_CrackTweet	破壳小鸡
Collection_Sweet_Masher	铁球武士
Collection_Sweet_IceDragon	冰龙
Collection_Sweet_KirbyCutter	弯刀卡比点阵
Collection_Sweet_LordKibble	勋爵弯刀骑士点阵
Collection_Sweet_MasterGreen	绿大师点阵
Collection_Sweet_NruffAndNelly	突进野猪&奈利点阵
Collection_Sweet_MrFrostyPixel	冰霜先生点阵
Collection_Sweet_DarkMatterPixel	暗物质点阵
Collection_Sweet_BlockBall	Kirby's Block Ball
Collection_Sweet_KirbyCook	厨师卡比
Collection_Sweet_KirbyJet	喷射机卡比
Collection_Sweet_KirybMirror	镜子卡比
Collection_Sweet_Wheelie	特技轮骑士点阵
Collection_Sweet_KirbyYoyo	溜溜球卡比点阵
Collection_Sweet_ChefKawasaki	厨师川崎点阵
Collection_Sweet_KnuckleJoe	格斗家乔点阵
Collection_Sweet_Marx	魔噜酷
Collection_Sweet_Tac	喵客点阵
Collection_Sweet_Walky	大声公
Collection_Sweet_AxeKnight	斧头骑士
Collection_Sweet_JavelinKnight	标枪骑士
Collection_Sweet_TridentKnight	三叉戟骑士
Collection_Sweet_MaceKnight	锤矛骑士
Collection_Sweet_DynaBlade	巨大锋翼鸟点阵
Collection_Sweet_RickBlock	陆库方块
Collection_Sweet_KineBlock	海恩方块
Collection_Sweet_CooBlock	空方块
Collection_Sweet_KirbyClean	清洁卡比点阵
Collection_Sweet_KirbyParasol	阳伞卡比
Collection_Sweet_Gooey	蛊依
Collection_Sweet_ChuChu	啾啾
Collection_Sweet_Nago	喵果
Collection_Sweet_Pitch	哔奇
Collection_Sweet_Gabon	骷髅怪点阵
Collection_Sweet_DarkMatterPixelColor	暗物质点阵
Collection_Sweet_Zero	零
Collection_Sweet_PonAndCon	阿狸&阿狐点阵
Collection_Sweet_MrStar	星仔
Collection_Sweet_TickTockJr	嘀嗒Jr.
Collection_Sweet_Gryll	考卢
Collection_Sweet_KirbyBurningStone	燃烧石块
Collection_Sweet_KirbyNeedle	针卡比
Collection_Sweet_Ribbon	妖精莉宝
Collection_Sweet_Adeleine	阿朵莱妮
Collection_Sweet_WaddleDee64	卡比&瓦豆鲁迪
Collection_Sweet_Dedede64	卡比&帝帝帝大王
Collection_Sweet_Nz	恩之
Collection_Sweet_Acro	鲸虎
Collection_Sweet_Magman	容炎
Collection_Sweet_Hrh	HR-H
Collection_Sweet_Blockbot	诺博特
Collection_Sweet_Blinkbat	扁福
Collection_Sweet_Orbservor	眼珠子
Collection_Sweet_Noddy	诺迪
Collection_Sweet_Gordo	黑刺球点阵
Collection_Sweet_FireLion	火狮
Collection_Sweet_PhanPhan	象象点阵
Collection_Sweet_PaintRoller	画画滚轮
Collection_Sweet_HeavyMole	重量级鼹鼠点阵
Collection_Sweet_MaximTomato	M番茄
Collection_Sweet_InvincibleCandy	彩虹棒棒糖
Collection_Sweet_Dragoon	龙骑兵
Collection_Sweet_Hydra	九头蛇
Collection_Sweet_WarpStarAirRide	传送之星
Collection_Sweet_ShadowStar	恶魔之星
Collection_Sweet_Caller	唤唤
Collection_Sweet_Flappy	龙鸟
Collection_Sweet_KirbyPhone	卡比（手机）点阵
Collection_Sweet_KirbyMissile	导弹卡比
Collection_Sweet_Mirra	镜蓝点阵
Collection_Sweet_Gobbler	加百猎点阵
Collection_Sweet_MasterHand	大师之手点阵
Collection_Sweet_CrazyHand	疯狂之手
Collection_Sweet_DarkMetaknight	暗魅塔骑士
Collection_Sweet_DarkMind	暗意向点阵
Collection_Sweet_KirbyBall	卡比球
Collection_Sweet_MetaknightBall	魅塔骑士球
Collection_Sweet_DededeBall	帝帝帝球
Collection_Sweet_Bloon	气球球点阵
Collection_Sweet_Drawcia	绘画堕落锡安 女巫点阵
Collection_Sweet_DrawciaSoul	绘画堕落锡安灵魂
Collection_Sweet_KirbyAnimal	动物卡比点阵
Collection_Sweet_KirbyGhost	幽灵卡比点阵
Collection_Sweet_Squeaker	吱鼠
Collection_Sweet_Doc	多库
Collection_Sweet_Storo	鼠泰隆
Collection_Sweet_Spinni	鼠宾
Collection_Sweet_Daroach	怪盗洛切
Collection_Sweet_DarkNebula	暗零
Collection_Sweet_KirbyNinja	忍者卡比
Collection_Sweet_KirbyPlasma	电离子卡比
Collection_Sweet_KirbySuplex	摔角手卡比
Collection_Sweet_SailorWaddleDee	船员瓦豆鲁迪
Collection_Sweet_GalacticNova	银河·新星
Collection_Sweet_MaskedDedede	蒙面·帝帝帝点阵
Collection_Sweet_GalactaKnight	星河骑士点阵
Collection_Sweet_MarxSoul	魔噜酷灵魂点阵
Collection_Sweet_EpicYarn	卡比
Collection_Sweet_Fluff	毛毛
Collection_Sweet_YinYarn	棒针狂人
Collection_Sweet_KirbyTwo	卡比（2人）
Collection_Sweet_Beanbon	叶芽
Collection_Sweet_Skully	头骨儿
Collection_Sweet_Skullord	头骨大王点阵
Collection_Sweet_KirbyCrackler	卡比（炮台）
Collection_Sweet_KirbyLeaf	叶子卡比
Collection_Sweet_KirbyWhip	鞭子卡比
Collection_Sweet_KirbyUltraSword	究极剑
Collection_Sweet_KirbyMonsterFlame	龙袭怒吼
Collection_Sweet_KirbySnowBowl	冰晶雪球
Collection_Sweet_Leafan	叶片怪
Collection_Sweet_Whippy	鞭皮
Collection_Sweet_BandanaWaddleDee	头巾瓦豆鲁迪
Collection_Sweet_MetaknightWii	魅塔骑士
Collection_Sweet_DededeWii	帝帝帝大王
Collection_Sweet_Magolor	魔法洛亚
Collection_Sweet_AllPlayerWii	与4位同伴一起
Collection_Sweet_Lor	洛亚
Collection_Sweet_MagolorPixel	魔法洛亚点阵
Collection_Sweet_DreamCollectionLogo1	20周年标志（1）
Collection_Sweet_DreamCollectionLogo2	20周年标志（2）
Collection_Sweet_KirbySmashBros	大乱斗卡比
Collection_Sweet_Kirby3dWarpStar	3D传送之星
Collection_Sweet_KirbyHypernova	大爆炸吸入
Collection_Sweet_KirbyBeetle	独角仙卡比
Collection_Sweet_KirbyBell	铜铃卡比
Collection_Sweet_KirbyCircus	马戏团卡比
Collection_Sweet_Beetley	大角甲虫
Collection_Sweet_Ringle	叮叮当
Collection_Sweet_Spynum	矢派南
Collection_Sweet_Taranza	塔狼蛛
Collection_Sweet_SunStone	太阳石
Collection_Sweet_SwordBeam	利剑VS光束
Collection_Sweet_ArcherFighter	狙击手VS格斗家
Collection_Sweet_TeamCannon	队伍合体炮
Collection_Sweet_DededeTambourine	帝帝帝大王（铃鼓）
Collection_Sweet_KirbyMegaphone	卡比（加油棒）
Collection_Sweet_Tambourine	铃鼓
Collection_Sweet_KirbyRainbowCurse	卡比
Collection_Sweet_Elline	艾莉妮
Collection_Sweet_Claycia	黏土西亚
Collection_Sweet_KirbyHelmet	卡比（安全帽）
Collection_Sweet_KirbyEsp	超能力卡比
Collection_Sweet_KirbyDoctor	医生卡比
Collection_Sweet_RobobotNormal	机器博博装甲
Collection_Sweet_RobobotJet	喷射机模式
Collection_Sweet_RobobotWheel	车轮模式
Collection_Sweet_WalkerWaddleDee	步行者瓦豆鲁迪
Collection_Sweet_BrontoBurt	飞翅球球
Collection_Sweet_Susie	秘书苏姿
Collection_Sweet_Haltmann	总裁·哈鲁特曼
Collection_Sweet_SwordHero	英雄利剑
Collection_Sweet_HammerLord	重锤子
Collection_Sweet_DoctorHealmore	治愈医生
Collection_Sweet_BeamMage	魔法光束
Collection_Sweet_KibbleBlade	弯刀骑士老大
Collection_Sweet_Inhale	卡比（吸入）
Collection_Sweet_FullBellyKirby	满腹卡比
Collection_Sweet_BlasterBulletKirby	卡比（贯通星形弹）
Collection_Sweet_Cake	豪华蛋糕堆
Collection_Sweet_KirbyPrinter	卡比打印机
Collection_Sweet_KirbyFighter	格斗家卡比
Collection_Sweet_ThrowFriendHeart	卡比
Collection_Sweet_FriendCircle	盟友滚轮
Collection_Sweet_SizzleYoyo	火焰溜溜球
Collection_Sweet_BonkersZapHammer	电气锤 锤星猩
Collection_Sweet_BladeKnightBlizzardSword	冰雪剑 剑骑士
Collection_Sweet_PoppyBrosJrBlusterBomb	风切炸弹 小波比兄弟
Collection_Sweet_Vividria	彩绘比比提安
Collection_Sweet_DededeStarAllies	帝帝帝大王
Collection_Sweet_Francisca	冰斧基斯
Collection_Sweet_Flamberge	炎剑露啾
Collection_Sweet_ZanPartizanne	雷枪帕噜提扎努
Collection_Sweet_VoidTermina	终焉·虚无
Collection_Sweet_MeDevil	本大爷·恶魔
Collection_Sweet_YeDevil	吾·恶魔
Collection_Sweet_WeDevil	我们·恶魔
Collection_Sweet_SwordHeroSuper	英雄利剑
Collection_Sweet_HammerLordSuper	重锤子
Collection_Sweet_DoctorHealmoreSuper	治愈医生
Collection_Sweet_BeamMageSuper	魔法光束
Collection_Sweet_ParallelNightmare	异次元梦魇
Collection_Sweet_AeonHero	围绕渊源的英雄
Collection_Sweet_ShopkeeperMagolor	店主魔法洛亚
Collection_Sweet_SwordWrestler	利剑&蒙面摔角手
Collection_Sweet_CheerStyle	啦啦队
Collection_Sweet_SumoTopknot	横纲发髻
Collection_Sweet_DededeMetaknight	帝帝帝大王&魅塔骑士
Collection_Sweet_DededeMetaknightMasked	蒙面·D&蒙面·M
Collection_Sweet_BuddyStarBlaster	搭档发射之星
Collection_Sweet_KirbyDiscovery	卡比
Collection_Sweet_BandanaWaddleDeeDiscovery	头巾瓦豆鲁迪
Collection_Sweet_Elfilin	艾菲灵
Collection_Sweet_CarMouth	汽车塞满嘴
Collection_Sweet_ConeMouth	三角锥塞满嘴
Collection_Sweet_VendingMouth	自动贩卖机塞满嘴
Collection_Sweet_RingMouth	圈圈塞满嘴
Collection_Sweet_KirbyDrill	钻击卡比
Collection_Sweet_KirbyRanger	探巡队卡比
Collection_Sweet_KirbyDragonFire	龙之烈火卡比
Collection_Sweet_KirbyDeepSleep	深层睡觉卡比
Collection_Sweet_Awoofy	加鲁鲁菲
Collection_Sweet_Gorimondo	猩猛霸
Collection_Sweet_Clawroline	卡洛凌
Collection_Sweet_DededeDiscovery	帝帝帝大王
Collection_Sweet_MetaknightDiscobery	魅塔骑士
Collection_Sweet_WeaponsShopWaddleDee	武器店瓦豆鲁迪
Collection_Sweet_CarMouthCake	汽车塞满嘴蛋糕
Collection_Sweet_KirbyElfilinWaddleDee	大家来摆姿势！
Collection_Sweet_CapturedWaddleDee	被囚禁的瓦豆鲁迪们
Collection_Sweet_KirbyMusicFest	卡比
Collection_Sweet_ElfilinMusicFest	艾菲灵
Collection_Sweet_MagolorMusicFest	魔法洛亚
Collection_Sweet_KirbyCafe	卡比
Collection_Sweet_WaddleDeeCafe	瓦豆鲁迪
Collection_Sweet_Logo30th	30周年标志
