strings
SYS_DIALOG_GENERIC_BUTTON1	
SYS_DIALOG_GENERIC_BUTTON2	
SYS_DIALOG_GENERIC_BUTTON3	
SYS_DIALOG_GENERIC_ITEM_OK	OK
SYS_DIALOG_GENERIC_ITEM_YES	はい
SYS_DIALOG_GENERIC_ITEM_NO	いいえ
SYS_DIALOG_GENERIC_ITEM_CANCEL	やめる
SYS_DIALOG_GENERIC_ITEM_INVITE	フレンドを招待する
SYS_DIALOG_GENERIC_ITEM_LATER	あとで
SYS_DIALOG_SAVE_CONFIRMATION_TEXT	上書きしますか？
SYS_DIALOG_SAVE_PROCESSING_TEXT	セーブしています
SYS_DIALOG_SAVE_COMPLETED_TEXT	セーブしました。
SYS_DIALOG_SAVE_FAILED_TEXT	セーブに失敗しました。
SYS_DIALOG_EXCHANGE_PLAYER_1P_TEXT	1Pと2Pを入れ替えました。\nあなたは 1P になりました。\nメニューの操作は引き続き  が行います。
SYS_DIALOG_EXCHANGE_PLAYER_2P_TEXT	1Pと2Pを入れ替えました。\nあなたは 2P になりました。\nメニューの操作は引き続き  が行います。
SYS_DIALOG_ONLINE_CONTROLLER_TEXT	オンラインで使えるコントローラーは1個です。\n続けますか？
SYS_DIALOG_WIRELESS_CONTROLLER_TEXT	ローカル通信で使えるコントローラーは1個です。\n続けますか？
SYS_DIALOG_ONLINE_CONNECTING_TEXT	インターネットに接続しています。
SYS_DIALOG_WIRELESS_CONNECTING_SHORT_TEXT	準備中です。
SYS_DIALOG_ONLINE_SEARCHING_TEXT	待っているフレンドを探しています。
SYS_DIALOG_WIRELESS_SEARCHING_TEXT	待っている相手を探しています。
SYS_DIALOG_ONLINE_CREATE_SESSION_TEXT	合言葉を用意しますか？\n合言葉を教えたフレンドのみ一緒に遊べます。
SYS_DIALOG_WIRELESS_CREATE_SESSION_TEXT	合言葉を用意しますか？\n合言葉を教えた相手のみ一緒に遊べます。
SYS_DIALOG_ONLINE_CREATE_SESSION_WITHOUT_PASSWORD	合言葉なし
SYS_DIALOG_ONLINE_CREATE_SESSION_WITH_PASSWORD	 合言葉あり
SYS_DIALOG_ONLINE_CREATING_SESSION_TEXT	オンラインプレイの準備をしています。
SYS_DIALOG_WIRELESS_CREATING_SESSION_SHORT_TEXT	準備中です。
SYS_DIALOG_ONLINE_CREATED_SESSION_TEXT	フレンドが合流したらお知らせします。\nこのまま待ちながら遊ぶことができます。
SYS_DIALOG_WIRELESS_CREATED_SESSION_TEXT	相手が合流したらお知らせします。\nこのまま待ちながら遊ぶことができます。
SYS_DIALOG_ONLINE_CREATED_SESSION_TEXT_INVITE	今すぐフレンドを招待しますか？\nあとで を選んだ場合、左側のメニューから招待できます。
SYS_DIALOG_ONLINE_PASSWORD_MISMATCH_TEXT	合言葉が違います。
SYS_DIALOG_ONLINE_FAILED_TO_JOIN_TEXT	フレンドとの合流に失敗しました。
SYS_DIALOG_WIRELESS_FAILED_TO_JOIN_TEXT	合流に失敗しました。
SYS_DIALOG_ONLINE_WAITING_FOR_GUEST_TEXT	 と合流しています。
SYS_DIALOG_ONLINE_WAITING_FOR_HOST_TEXT	 と合流しています。\n（あなたのセーブデータは変更されません）
SYS_DIALOG_ONLINE_WAITING_FOR_HOST_USESRAM_TEXT	 と合流しています。
SYS_DIALOG_ONLINE_ESTABLISHED_HOST_TEXT	 が遊びに来ました。\nメニューの操作は  が行います。\n通信品質は自分と相手との通信環境に依存します。
SYS_DIALOG_ONLINE_ESTABLISHED_GUEST_TEXT	 のところへ遊びに来ました。\nメニューの操作は  が行います。\n通信品質は自分と相手との通信環境に依存します。
SYS_DIALOG_QUIT_ONLINE_PLAY_TEXT	オンラインプレイをやめます。\nよろしいですか？
SYS_DIALOG_QUIT_WIRELESS_PLAY_TEXT	ローカル通信をやめます。\nよろしいですか？
SYS_DIALOG_DURING_GUEST_OPERATION_TEXT	 が操作しています。
SYS_DIALOG_DURING_HOST_OPERATION_TEXT	 が操作しています。
SYS_DIALOG_LEAVING_ONLINE_PLAY_TEXT	オンラインプレイを終了しています。
SYS_DIALOG_LEAVING_WIRELESS_PLAY_TEXT	ローカル通信を終了しています。
SYS_DIALOG_NEW_ARRIVAL_INFORMATION_TEXT	タイトルが追加されました。
SYS_DIALOG_ERROR_EMULATOR_CRASHED_TEXT	ゲーム内でエラーが発生しました。
SYS_DIALOG_ONLINE_PAUSE_ON_DISCONNECT_TEXT	通信が切断されました。\nこのままゲームを続けることができません。\nどこでもセーブのみ可能です。
SYS_DIALOG_ONLINE_TITLE_PROHIBITED_TEXT	このタイトルは選ぶことができません。
SYS_DIALOG_ONLINE_OVERCROWDING_TEXT	このタイトルは2人プレイ専用です。\n2人でプレイしているときのみ選ぶことができます。
SYS_DIALOG_LAUNCHING_ANOTHER_ONE	 の本体では別のタイトルが起動します。\n（ が操作してください）
SYS_DIALOG_LAUNCHING_OTHERS_ONE	 の本体ではどのタイトルを起動しますか？\n（ が操作してください）
SYS_DIALOG_LAUNCHING_OTHERS	 以外の本体ではどのタイトルを起動しますか？\n（ が操作してください）
SYS_HUD_GUIDE_PRO_CONFIRM	  決定
SYS_HUD_GUIDE_PRO_BACK	  もどる
SYS_HUD_GUIDE_PRO_DETAILS	  くわしく
SYS_HUD_GUIDE_PRO_MOVE	  移動
SYS_HUD_GUIDE_PRO_MOVE2	  移動　（長押しでソート）
SYS_HUD_GUIDE_PRO_SORT	  長押しでソート
SYS_HUD_GUIDE_PRO_PLAY	  はじめる
SYS_HUD_GUIDE_PRO_GUIDE	  操作ガイド
SYS_HUD_GUIDE_PRO_EXCHANGE	  1P/2P入れ替え
SYS_HUD_GUIDE_PRO_VOICE_CHAT	  ボイスチャットするには？
SYS_HUD_GUIDE_PRO_INGAME_PAUSE	 +   中断メニュー
SYS_HUD_GUIDE_PRO_INGAME_START	  STARTボタン
SYS_HUD_GUIDE_PRO_INGAME_SELECT	  SELECTボタン
SYS_HUD_GUIDE_PRO_INGAME_QUIT_ONLINE	 +   オンラインプレイをやめる
SYS_HUD_GUIDE_PRO_INGAME_QUIT_WIRELESS	 +   ローカル通信をやめる
SYS_HUD_GUIDE_PRO_DETAILES_NEXT	  つぎへ
SYS_HUD_GUIDE_PRO_COMMIT	  確定
SYS_HUD_GUIDE_PRO_CANCEL	  元にもどす
SYS_HUD_GUIDE_PRO_SINGLE_PAK	  1カートリッジプレイ
SYS_HUD_GUIDE_PRO_MULTI_PAK	  マルチカートリッジプレイ
SYS_HUD_GUIDE_JOY_L_SINGLE_PAK	  1カートリッジプレイ
SYS_HUD_GUIDE_JOY_L_MULTI_PAK	　マルチカートリッジプレイ
SYS_HUD_GUIDE_JOY_R_SINGLE_PAK	  1カートリッジプレイ
SYS_HUD_GUIDE_JOY_R_MULTI_PAK	　マルチカートリッジプレイ
SYS_HUD_GUIDE_JOY_L_CONFIRM	  決定
SYS_HUD_GUIDE_JOY_R_CONFIRM	  決定
SYS_HUD_GUIDE_JOY_L_BACK	  もどる
SYS_HUD_GUIDE_JOY_R_BACK	  もどる
SYS_HUD_GUIDE_JOY_L_DETAILS	  くわしく
SYS_HUD_GUIDE_JOY_R_DETAILS	  くわしく
SYS_HUD_GUIDE_JOY_L_MOVE	  移動
SYS_HUD_GUIDE_JOY_L_MOVE2	  移動　（長押しでソート）
SYS_HUD_GUIDE_JOY_L_SORT	  長押しでソート
SYS_HUD_GUIDE_JOY_R_MOVE	  移動
SYS_HUD_GUIDE_JOY_R_MOVE2	  移動　（長押しでソート）
SYS_HUD_GUIDE_JOY_R_SORT	  長押しでソート
SYS_HUD_GUIDE_JOY_L_PLAY	  はじめる
SYS_HUD_GUIDE_JOY_R_PLAY	  はじめる
SYS_HUD_GUIDE_JOY_L_GUIDE	  操作ガイド
SYS_HUD_GUIDE_JOY_R_GUIDE	  操作ガイド
SYS_HUD_GUIDE_JOY_L_EXCHANGE	  1P/2P入れ替え
SYS_HUD_GUIDE_JOY_R_EXCHANGE	  1P/2P入れ替え
SYS_HUD_GUIDE_JOY_L_VOICE_CHAT	  ボイスチャットするには？
SYS_HUD_GUIDE_JOY_R_VOICE_CHAT	  ボイスチャットするには？
SYS_HUD_GUIDE_JOY_L_INGAME_PAUSE	 +   中断メニュー
SYS_HUD_GUIDE_JOY_R_INGAME_PAUSE	 +   中断メニュー
SYS_HUD_GUIDE_JOY_L_INGAME_START	 +   STARTボタン
SYS_HUD_GUIDE_JOY_R_INGAME_START	 +   STARTボタン
SYS_HUD_GUIDE_JOY_L_INGAME_SELECT	 +   SELECTボタン
SYS_HUD_GUIDE_JOY_R_INGAME_SELECT	 +   SELECTボタン
SYS_HUD_GUIDE_JOY_L_INGAME_QUIT_ONLINE	 +   オンラインプレイをやめる
SYS_HUD_GUIDE_JOY_L_INGAME_QUIT_WIRELESS	 +   ローカル通信をやめる
SYS_HUD_GUIDE_JOY_R_INGAME_QUIT_ONLINE	 +   オンラインプレイをやめる
SYS_HUD_GUIDE_JOY_R_INGAME_QUIT_WIRELESS	 +   ローカル通信をやめる
SYS_HUD_GUIDE_JOY_L_DETAILS_NEXT	  つぎへ
SYS_HUD_GUIDE_JOY_R_DETAILS_NEXT	  つぎへ
SYS_HUD_GUIDE_JOY_L_COMMIT	  確定
SYS_HUD_GUIDE_JOY_R_COMMIT	  確定
SYS_HUD_GUIDE_JOY_L_CANCEL	  元にもどす
SYS_HUD_GUIDE_JOY_R_CANCEL	  元にもどす
SYS_HUD_GUIDE_PRO_TOGGLE_SCREEN_SHARE	  画面を見せる/かくす
SYS_HUD_GUIDE_JOY_L_TOGGLE_SCREEN_SHARE	  画面を見せる/かくす
SYS_HUD_GUIDE_JOY_R_TOGGLE_SCREEN_SHARE	  画面を見せる/かくす
SYS_HUD_GUIDE_PRO_INGAME_PAUSE_WITH_SCREENSHARE	 +   中断メニュー（長押しで画面を見せる）
SYS_HUD_GUIDE_JOY_L_INGAME_PAUSE_WITH_SCREENSHARE	 +   中断メニュー（長押しで画面を見せる）
SYS_HUD_GUIDE_JOY_R_INGAME_PAUSE_WITH_SCREENSHARE	 +   中断メニュー（長押しで画面を見せる）
SYS_INFO_NICKNAME_OWN	
SYS_INFO_NICKNAME_PLAYER1	
SYS_INFO_NICKNAME_PLAYER2	
SYS_INFO_ROLE_PLAYER1	1P
SYS_INFO_ROLE_PLAYER2	2P
SYS_INFO_SESSION_PASSWORD	
SYS_MENU_ROOT_ITEM_ONE_PLAYER	ひとりで遊ぶ
SYS_MENU_ROOT_ITEM_TWO_PLAYERS	ふたりで遊ぶ
SYS_MENU_ROOT_ITEM_ONLINE_PLAY	オンラインで遊ぶ
SYS_MENU_ROOT_ITEM_WIRELESS_PLAY	ローカル通信で遊ぶ
SYS_MENU_ROOT_ITEM_STOP_ONLINE_PLAY	オンラインをやめる
SYS_MENU_ROOT_ITEM_STOP_WIRELESS_PLAY	ローカル通信をやめる
SYS_MENU_ROOT_ITEM_SETTINGS	設定
SYS_MENU_ROOT_ITEM_INVITE	フレンドを招待する
SYS_MENU_ROOT_SESSION_COUNTER	
SYS_MENU_ONLINE_GUIDE_SUBJECT	オンラインで遊ぶ
SYS_MENU_ONLINE_GUIDE_DESC1	・ オンラインでフレンドとふたりで一緒に遊べます。\n\n・ ひとりで遊びながら、フレンドを待つことができます。\n\n・ スマートフォンアプリ 「Nintendo Switch Online」 が\n　 あればボイスチャットが利用できます。
SYS_MENU_ONLINE_GUIDE_DESC1_SUP	\n\n・ 通信プレイ対応タイトルのみ遊べます。
SYS_MENU_ONLINE_GUIDE_DESC2_ONLINE_PLAY	オンラインプレイでは「どこでもセーブ」は使えません。\nゲーム内のセーブデータを使って遊びます。
SYS_MENU_ONLINE_GUIDE_DESC2_WIRELESS_PLAY	ローカル通信では「どこでもセーブ」は使えません。\nゲーム内のセーブデータを使って遊びます。
SYS_MENU_WIRELESS_GUIDE_SUBJECT	ローカル通信で遊ぶ
SYS_MENU_WIRELESS_GUIDE_DESC2	・ ローカル通信でふたりで一緒に遊べます。\n\n・ ひとりで遊びながら、相手を待つことができます。\n\n・ 通信プレイ対応タイトルのみ遊べます。
SYS_MENU_ONLINE_ITEM_CREATE_SESSION	遊びながら待つ
SYS_MENU_ONLINE_ITEM_SESSION1	
SYS_MENU_ONLINE_ITEM_SESSION2	
SYS_MENU_ONLINE_ITEM_SESSION3	
SYS_MENU_ONLINE_ITEM_SESSION4	
SYS_MENU_ONLINE_ITEM_SESSION5	
SYS_MENU_ONLINE_ITEM_SESSION6	
SYS_MENU_ONLINE_ITEM_PLAYING	プレイ中
SYS_MENU_ONLINE_DESC_CREATE_SESSION	ひとりで遊びながら、フレンドを待ちます
SYS_MENU_WIRELESS_DESC_CREATE_SESSION	ひとりで遊びながら、相手を待ちます
SYS_MENU_ONLINE_DESC_CREATE_SESSION_INVITE	遊びながらフレンドを待ちます\nフレンドに招待を送ることもできます
SYS_MENU_ONLINE_DESC_SESSION_LIST	一緒に遊ぶフレンドを選びます　 再検索
SYS_MENU_WIRELESS_DESC_SESSION_LIST	一緒に遊ぶ相手を選びます　 再検索
SYS_MENU_ONLINE_DESC_SESSION_LIST_JOY_L	一緒に遊ぶフレンドを選びます　 再検索
SYS_MENU_WIRELESS_DESC_SESSION_LIST_JOY_L	一緒に遊ぶ相手を選びます　 再検索
SYS_MENU_ONLINE_DESC_SESSION_LIST_JOY_R	一緒に遊ぶフレンドを選びます　 再検索
SYS_MENU_WIRELESS_DESC_SESSION_LIST_JOY_R	一緒に遊ぶ相手を選びます　 再検索
SYS_MENU_ONLINE_DESC_SESSION_LIST_INVITE	合流するフレンドを選びます　 再検索
SYS_MENU_WIRELESS_DESC_SESSION_LIST_INVITE	合流する相手を選びます　 再検索
SYS_MENU_ONLINE_DESC_SESSION_LIST_JOY_L_INVITE	合流するフレンドを選びます　 再検索
SYS_MENU_ONLINE_DESC_SESSION_LIST_JOY_R_INVITE	合流するフレンドを選びます　 再検索
SYS_MENU_ONLINE_NOTICE_NOT_FOUND	一緒に遊べるフレンドがいません
SYS_MENU_WIRELESS_NOTICE_NOT_FOUND	一緒に遊べる相手がいません
SYS_MENU_ONLINE_NOTICE_NOT_FOUND_INVITE	遊んでいるフレンドがいません
SYS_MENU_ONLINE_KEYBOARD_HEADER	合言葉（3桁の数字）を入力してください
SYS_MENU_ONLINE_KEYBOARD_GUIDE	3ケタの数字
SYS_MENU_SETTINGS_ITEM_4_3	4:3
SYS_MENU_SETTINGS_ITEM_PIXEL_PERFECT	ピクセルパーフェクト
SYS_MENU_SETTINGS_ITEM_CRT	アナログテレビ
SYS_MENU_SETTINGS_DESC_GAME_SCREEN	ゲーム画面
SYS_MENU_SETTINGS_DESC_GUIDE_DISPLAY	ゲーム中のボタン割り当て表示
SYS_MENU_SETTINGS_ITEM_GUIDE_DISPLAY	表示する
SYS_MENU_SETTINGS_ITEM_SCREEN_SIZE	画面を小さく表示する
SYS_MENU_SETTINGS_ITEM_NOSTALGIC_MODE	当時の雰囲気を再現する
SYS_MENU_SETTINGS_LCLA4EXPLANATION	ゲームボーイカラー専用・共通タイトルは常に\nゲームボーイカラーで動作します。
SYS_MENU_PAUSE_ITEM_CONTINUE	つづける
SYS_MENU_PAUSE_ITEM_LOAD	ロード
SYS_MENU_PAUSE_ITEM_SAVE	どこでもセーブ
SYS_MENU_PAUSE_ITEM_RESET	リセット
SYS_MENU_PAUSE_ITEM_RETURN_TO_MENU	タイトル選択にもどる
SYS_MENU_DETAILS_DESC_RELEASE_INFO	　　年発売
SYS_MENU_DETAILS_DESC_PLAY_INFO_LONG_TIME	プレイ人数：人　　プレイ時間：時間分
SYS_MENU_DETAILS_DESC_PLAY_INFO_SHORT_TIME	プレイ人数：人　　プレイ時間：分
SYS_MENU_DETAILS_DESC_PLAY_INFO_NO_TIME	プレイ人数：人
SYS_MENU_DETAIL_PAGE	 / 
SYS_MENU_SAVESLOT_NO_IMAGE	No Data
SYS_MENU_SAVESLOT_ITEM_EMPTY	セーブデータ
SYS_MENU_SAVESLOT_ITEM_VALID	セーブデータ\n// :
SYS_MENU_SORT_INDEX	●
SYS_MENU_SORT_INDEX_00	〇
SYS_MENU_SPECIAL_EMBLEM	SP
SYS_MENU_SPECIAL_TEXT	SPECIAL
SYS_MENU_SPECIAL2_TEXT	SPECIAL 
SYS_MENU_NEW_GAME_TEXT	NEW
SYS_MENU_FRIENDPRESENCE	プレイ中のゲーム ： 
SYS_MENU_WAITING_FOR_HOST_DESC	相手がゲームをプレイ中です。\n\n相手がタイトル選択にもどると一緒に遊べます。\nお待ちください。
SYS_MENU_MULTI_PLAYER_PRE_GUIDANCE_P1	自分と相手はそれぞれ\n別々のゲーム画面を操作します
SYS_MENU_MULTI_PLAYER_PRE_GUIDANCE_P2	中断メニューから\nタイトルごとの通信プレイのはじめかたが見られます
SYS_MENU_INGAME_EXIT_QUERY_SUBJECT	全員が「はい」を選ぶとタイトル選択にもどります
SYS_MENU_INGAME_EXIT_QUERY_DESC_SRAM	誰かが「いいえ」を選ぶとゲームを再開します\n（セーブが必要な場合は「いいえ」を選んでセーブしてください）
SYS_MENU_INGAME_SCREENSHOT_IS_HIDDEN	画面をかくしています
SYS_MENU_PAUSE_ITEM_BATTLE_GUIDE	通信プレイのはじめかた
SYS_MENU_ONLINE_DESC_CREATE_SESSION_INVITE_HANDHELD	ボイスチャットをしながら遊ぶことをおすすめします\nフレンドに招待を送ることもできます
SYS_MENU_INGAME_PLAYER_SELF	自分
SYS_MENU_INGAME_PLAYER_PARTNER	相手
SYS_NOTIFICATION_QUIT_ONLINE_PLAY_TEXT	オンラインプレイをやめました。
SYS_NOTIFICATION_QUIT_WIRELESS_PLAY_TEXT	ローカル通信をやめました。
SYS_NOTIFICATION_OTHER_PLAYER_MISSING_TEXT	 との通信が切断されました。\n引き続き遊びながらフレンドを待ちます。
SYS_NOTIFICATION_OTHER_PLAYER_MISSING_TEXT_WIRELESS	 との通信が切断されました。\n引き続き遊びながら相手を待ちます。
SYS_NOTIFICATION_OTHER_PLAYER_MISSING_TEXT_GUEST	 との通信が切断されました。
SYS_NOTIFICATION_OTHER_PLAYER_MISSING2_TEXT	 との通信が切断されました。
SYS_NOTIFICATION_UNSTABLE_NETWORK2_TEXT	自分と相手との通信環境が悪いため快適にプレイできない可能性があります。
SYS_NOTIFICATION_CONNECTED_CONTROLLER_NUM_1_TEXT	つながっているコントローラーが1個になりました。
SYS_NOTIFICATION_CONNECTED_CONTROLLER_NUM_2_TEXT	つながっているコントローラーが2個になりました。
SYS_NOTIFICATION_OPERATION_DENIED_TEXT	 が操作しています。
SYS_NOTIFICATION_DENIED_MOVE_OPERATION_TEXT	タイトルを移動することができません。\nソートで「お好きな順」に変更する必要があります。
SYS_NOTIFICATION_SINGLE_PAK_TEXT	1カートリッジプレイに対応したタイトルのみ遊ぶことができます。
SYS_NOTIFICATION_MULTI_PAK_TEXT	マルチカートリッジプレイに戻しました。
SYS_POPUP_GUIDE_PRO_CONTROLLER_SELECT	カーソルを移動させるには\n ボタン
SYS_POPUP_GUIDE_PRO_CONTROLLER_START	ゲームをスタートするには\n ボタン
SYS_POPUP_GUIDE_JOY_L_CONTROLLER_SELECT	カーソルを移動させるには\n + 
SYS_POPUP_GUIDE_JOY_L_CONTROLLER_START	ゲームをスタートするには\n + 
SYS_POPUP_GUIDE_JOY_R_CONTROLLER_SELECT	カーソルを移動させるには\n + 
SYS_POPUP_GUIDE_JOY_R_CONTROLLER_START	ゲームをスタートするには\n + 
SYS_POPUP_GUIDE_PRO_PAUSE_MENU	ゲームを中断するには  + 
SYS_POPUP_GUIDE_JOY_L_PAUSE_MENU	ゲームを中断するには  + 
SYS_POPUP_GUIDE_JOY_R_PAUSE_MENU	ゲームを中断するには  + 
SYS_POPUP_GUIDE_PRO_SWAP_PLAYERS	1P/2Pの入れ替えは、中断メニューで  ボタン
SYS_POPUP_GUIDE_JOY_L_SWAP_PLAYERS	1P/2Pの入れ替えは、中断メニューで  ボタン
SYS_POPUP_GUIDE_JOY_R_SWAP_PLAYERS	1P/2Pの入れ替えは、中断メニューで  ボタン
SYS_POPUP_GUIDE_LARK_SWAP_PLAYERS	1P/2Pの入れ替えは、中断メニューから。
SYS_POPUP_GUIDE_FINGER_CURSOR	 でおててカーソル、 （押し込み）で拍手
SYS_POPUP_GUIDE_FINGER_CURSOR_02	 でおててカーソル、 （押し込み）で拍手\nゲームプレイ中は出せません
SYS_POPUP_GUIDE_PRO_REWIND	ミスしても大丈夫。  +  長押しで巻き戻し。\n好きなところからやり直せます。
SYS_POPUP_GUIDE_JOY_L_REWIND	ミスしても大丈夫。  +  長押しで巻き戻し。\n好きなところからやり直せます。
SYS_POPUP_GUIDE_JOY_R_REWIND	ミスしても大丈夫。  +  長押しで巻き戻し。\n好きなところからやり直せます。
SYS_POPUP_GUIDE_PRO_SCREEN_SHARE	 +  長押しでゲーム画面を共有できます。
SYS_POPUP_GUIDE_JOY_L_SCREEN_SHARE	 +  長押しでゲーム画面を共有できます。
SYS_POPUP_GUIDE_JOY_R_SCREEN_SHARE	 +  長押しでゲーム画面を共有できます。
SYS_NOTIFICATION_NEW_PLAYER_WAITING_TEXT	相手と一緒に遊ぶには、一度タイトル選択にもどってください。
SYS_NOTIFICATION_MAY_SAVE_TEXT	セーブが必要な場合はセーブしてください。
SYS_NOTIFICATION_OPERATION_ON_TEXT	あなたが操作します
SYS_NOTIFICATION_OPERATION_OFF_TEXT	相手が操作します
SYS_HUD_GUIDE_PRO_INGAME_PAUSE_WITH_REWIND	 +   中断メニュー（長押しで巻き戻し）
SYS_HUD_GUIDE_JOY_L_INGAME_PAUSE_WITH_REWIND	 +   中断メニュー（長押しで巻き戻し）
SYS_HUD_GUIDE_JOY_R_INGAME_PAUSE_WITH_REWIND	 +   中断メニュー（長押しで巻き戻し）
SYS_SORT_ORDER_CUSTOM	お好きな順
SYS_SORT_ORDER_RELEASE_DATE	発売日順
SYS_SORT_ORDER_TITLE_NAME	タイトル名順
SYS_SORT_ORDER_PUBLISHER	パブリッシャー名順
SYS_SORT_ORDER_2PLAYER_GAMES	2P同時プレイ順
SYS_SORT_ORDER_DELIVERY_DATE	配信順
SYS_SORT_ORDER_DESC_TEXT	タイトルの並び順を変更します
SYS_SORT_ORDER_NAME_CUSTOM	お好きな順
SYS_SORT_ORDER_NAME_ALPHABETICAL	あいうえお順
SYS_SORT_ORDER_NAME_RELEASE_DATE	発売された順
SYS_SORT_ORDER_NAME_RECENTLY_PLAYED	最近遊んだ順
SYS_SORT_ORDER_NAME_PLAY_TIME	プレイ時間が長い順
SYS_SORT_HEADING_PLAY_TIME	分
SYS_SORT_HEADING_PLAY_TIME_2	1分未満
SYS_SORT_HEADING_DATE_PLAYED_1	//
SYS_SORT_HEADING_DATE_PLAYED_2	/
SYS_USER_GUIDE_CONTROLLER_A	A
SYS_USER_GUIDE_CONTROLLER_B	B
SYS_USER_GUIDE_CONTROLLER_X	X
SYS_USER_GUIDE_CONTROLLER_Y	Y
SYS_USER_GUIDE_CONTROLLER_L	L
SYS_USER_GUIDE_CONTROLLER_R	R
SYS_USER_GUIDE_CONTROLLER_DPAD	十字ボタン
SYS_USER_GUIDE_CONTROLLER_SELECT	SELECT
SYS_USER_GUIDE_CONTROLLER__START	START
SYS_USER_GUIDE_PRO_POINTER	おててカーソル\n（押し込みで拍手）\n※オンラインプレイ時のみ
SYS_USER_GUIDE_PRO_POINTER_01	おててカーソル\n（押し込みで拍手）\n※通信プレイ時のみ
SYS_USER_GUIDE_JOY_L_COMBINATION	 +  SELECT     +  START
SYS_USER_GUIDE_JOY_R_COMBINATION	 +  SELECT     +  START
SYS_USER_GUIDE_PAUSE_MENU	中断メニュー
SYS_USER_GUIDE_SYSTEM_HOME	 HOMEメニュー
SYS_USER_GUIDE_SYSTEM_CAPTURE	 キャプチャー
SYS_USER_GUIDE_SYSTEM_CAPTURE2	キャプチャー 
SYS_CONNECT_GUIDE_TITLE_HEADING	『』通信プレイのはじめかた
SYS_CONNECT_GUIDE_SUPPLEMENT_01	うまくいかなかった場合は「タイトル選択にもどる」を選んでやり直してください。
SYS_CONNECT_GUIDE_SUPPLEMENT_02	スマートフォンアプリ『Nintendo Switch Online』などでボイスチャットをしながらプレイしましょう。
META_TITLE_COMMENT_C_3996_j	アイテムを駆使して、「夢をみる島」の謎を解く。\n\nこのタイトルは、1998年に発売されたゲームボーイカラー用のアクションアドベンチャーゲームです。嵐に巻き込まれ南の島「コホリント島」に打ち上げられたリンク。島からの脱出を目指し、リンクの冒険がはじまります。おなじみの剣と盾、島で入手する様々なアイテムを駆使して、洞窟や神殿の謎を解いたとき、コホリント島の本当の姿が明らかに。
META_TITLE_COMMENT_D_7984_j	魔界の危機。望みは悪魔の戦士･レッドアリーマー。\n\nこのタイトルは、1990年に発売されたゲームボーイ用のアクションゲームです。アクションゲーム『魔界村』の敵キャラクター・レッドアリーマーが、このゲームの主人公。謎の大軍団によって壊滅状態になった魔界を救うため、レッドアリーマーが立ち上がります。レッドアリーマーの特技は、空を飛んだり壁に張り付いたりするなどのアクションと敵を攻撃する魔力。敵と戦って新しい魔力を身につけていき、謎の大軍団との戦いに挑みます。
META_TITLE_COMMENT_D_5124_j	マリオの新しいライバル、ワリオが初登場。\n\nこのタイトルは、1992年に発売されたゲームボーイ用のアクションゲームです。ワリオによって占領されたマリオ城を取り戻すため、マリオは「6つの金貨」を集める冒険に出発します。冒険の舞台は、月や星を駆け巡る「スペースゾーン」、ミクロの大きさに変身する「マクロゾーン」、水の中を泳いで進む「タートルゾーン」といった特徴の異なる6つのゾーン。マリオは、ファイアボールを投げられる「ファイアマリオ」や、大きくジャンプできる「バニーマリオ」などにパワーアップして、敵を倒していきます。
META_TITLE_COMMENT_D_5661_j	なんでも吸い込むまんまるカービィのデビュー作。\n\nこのタイトルは、1992年に発売されたゲームボーイ用のアクションゲームです。まんまるの主人公カービィの得意技は、大きな口でなんでも吸い込むこと。吸い込んだ敵を星に変えてほかの敵にぶつけたり、空気を吸い込んで空を飛んだりすることができます。カービィが住む国「プププランド」の自称王様「デデデ大王」から、プププランドのすべての食べ物と秘宝「きらきらぼし」を取り戻すため、カービィがデデデ大王の城に向かいます。
META_TITLE_COMMENT_C_5928_j	不思議な世界に閉じ込められたワリオ。\nオルゴールとお宝を探し出し、元の世界に戻れるか？\n\nこのタイトルは、2000年に発売されたゲームボーイカラー用のアクションゲームです。オルゴールの世界に閉じ込められたワリオが、封印を解いて元の世界へ戻るため、オルゴールやお宝を探します。冒険の舞台は、昼と夜で出てくる敵やお宝が異なる不思議な世界。ジャンプやアタックなどのアクションと、敵の攻撃で感電する･氷づけになるなどの「リアクション」で、さまざまな仕掛けを突破します。特定のお宝を取るとワリオが新しいアクションを覚えたり、コースが変化したりして、以前はたどり着けなかった場所を探索できるようになります。
META_TITLE_COMMENT_C_3381_j	「むかし」（1980年代）と「いま」（1999年発売当時）が楽しめる。\n\nこのタイトルは、1999年に発売されたゲームボーイカラー用のアクションゲームです。1980年代に発売された携帯型液晶ゲーム機「ゲーム＆ウオッチ」のタイトルを収録。転がってくる食べ物を受ける「エッグ」、両はしの花をねらってくる敵を攻撃する「グリーンハウス」、左側で受け取った荷物を右側の人に渡して戻ってくる「タートルブリッジ」、コンベアの左右にいるマリオ達を操作して荷物やケーキを落とさないようにトラックまで運ぶ「マリオブラザーズ」、ジャンプやツタで敵をかわしながらカギを取ってコングを助けに行く「ドンキーコングJR.」の5タイトルが遊べます。各タイトルはオリジナルのゲーム＆ウオッチが楽しめる「むかし」モードと、現代風にアレンジした「いま」モードの2種類が入っています。高得点を獲得し☆を集めるとギャラリーコーナーに「おんがくしつ」や「ミュージアム」が追加されていき、さらにはおまけとして上記の5タイトル以外のゲームも遊べるようになります。☆をたくさん集めてゲーム＆ウオッチ博士になろう！
META_TITLE_CONNECT_GUIDE_01_C_3381_j	通信プレイの前に\nこのタイトルで通信プレイをするには二人ともゲーム内の☆を20個以上集めておく必要があります。通信プレイができるのは「JUDGE」というゲームのみです。集めた☆の数はタイトル画面で「ギャラリーを見る」を選ぶと確認できます。
META_TITLE_CONNECT_GUIDE_02_C_3381_j	STEP1\n二人ともそれぞれタイトル画面から「ゲームをあそぶ」、「▶ ▶ ▶」、\n「JUDGE」の順に選んでいってください。
META_TITLE_CONNECT_GUIDE_03_C_3381_j	STEP2\n二人ともこの画面にいる状態で、どちらかが右ボタンを押して「2P」と表示されていることを確認し、AボタンまたはSTARTボタンを押すと通信プレイがはじまります。
META_TITLE_COMMENT_D_1577_j	緊急指令。サムス アランに告ぐ、メトロイドを全滅せよ。\n\nこのタイトルは、1992年に発売されたゲームボーイ用のアクションゲームです。 銀河連邦より主人公「サムス アラン」に与えられた任務は、惑星SR388の地底に潜む浮遊生命体「メトロイド」の全滅。サムスはビームやミサイルといった武器を使って、行く手を阻む敵と戦います。ジャンプ力をアップする「ハイジャンプブーツ」、敵などを凍らせる「アイスビーム」といった豊富なアイテムを活用して、惑星内をくまなく探索し、地底内のメトロイドを倒していきます。
META_TITLE_COMMENT_D_8484_j	懐かしくて奥深い。最もシンプルなテトリス。\n\nこのタイトルは、1989年に発売されたゲームボーイ用のパズルゲームです。どんどん落ちてくる7種類のテトリミノ（ブロック）を左右に動かしたり、回転させたりして、ねらった場所に積み重ねていきます。横一列のラインをつくると、テトリミノが消えて得点がアップ。着実に一列ずつ消すもよし、数列まとめて消して高得点をねらうもよし。ひとつとして同じ状況がない中で、思考を巡らせる楽しさが味わえます。1PLAYERゲームでは、ゲームオーバーになるまでラインを消し続ける「A-TYPE」、限られたライン数でハイスコアを目指す「B-TYPE」の2種類が選べます。対戦型の2PLAYERゲームでは先に30ラインを消すか、相手のブロックを先にフィールドの上まで押し上げてしまえば勝ちとなります。
META_TITLE_CONNECT_GUIDE_01_D_8484_j	二人ともタイトル画面にいるときに、どちらかが「2PLAYER」にカーソルを合わせてSTARTボタンを押すと通信プレイがはじまります。
META_TITLE_COMMENT_D_1504_j	携帯型ゲーム機で欠かせないソフトといえば、やっぱり麻雀。\n\nこのタイトルは、1989年に発売されたゲームボーイ用のテーブルゲームです。この「役満」があればいつでもどこでも手軽に麻雀が楽しめます。ゲームは1人用と2人用があり、1人用は個性的な5人のコンピュータ雀士から1人を選び、2人麻雀で勝負します。ルールはお好みで設定でき、コンピュータの思考も素早いので、時間を忘れて熱くなれます。2人用で遊べば、人対人で実戦さながらの真剣勝負が味わえます。これでもう4人そろわなくても大丈夫？
META_TITLE_CONNECT_GUIDE_01_D_1504_j	STEP1\n二人ともタイトル画面にいるときに、どちらかが「2 プレイヤー」を選ぶと通信プレイがはじまります。
META_TITLE_CONNECT_GUIDE_02_D_1504_j	STEP2\n先に「2 プレイヤー」を選んだプレイヤーがルールを設定して、「オワル」を選ぶと対局がはじまります。
exploded_strings
SYS_DIALOG_GENERIC_BUTTON1	[GENERIC_DIALOG_BUTTON1]
SYS_DIALOG_GENERIC_BUTTON2	[GENERIC_DIALOG_BUTTON2]
SYS_DIALOG_GENERIC_BUTTON3	[GENERIC_DIALOG_BUTTON3]
SYS_DIALOG_EXCHANGE_PLAYER_1P_TEXT	1Pと2Pを入れ替えました。\nあなたは 1P になりました。\nメニューの操作は引き続き [PLAYER1_NAME] が行います。
SYS_DIALOG_EXCHANGE_PLAYER_2P_TEXT	1Pと2Pを入れ替えました。\nあなたは 2P になりました。\nメニューの操作は引き続き [PLAYER1_NAME] が行います。
SYS_DIALOG_ONLINE_CREATE_SESSION_WITH_PASSWORD	[IMG_LOCK] 合言葉あり
SYS_DIALOG_ONLINE_WAITING_FOR_GUEST_TEXT	[JOINNER_NAME] と合流しています。
SYS_DIALOG_ONLINE_WAITING_FOR_HOST_TEXT	[PLAYER1_NAME] と合流しています。\n（あなたのセーブデータは変更されません）
SYS_DIALOG_ONLINE_WAITING_FOR_HOST_USESRAM_TEXT	[PLAYER1_NAME] と合流しています。
SYS_DIALOG_ONLINE_ESTABLISHED_HOST_TEXT	[JOINNER_NAME] が遊びに来ました。\nメニューの操作は [PLAYER1_NAME] が行います。\n通信品質は自分と相手との通信環境に依存します。
SYS_DIALOG_ONLINE_ESTABLISHED_GUEST_TEXT	[PLAYER1_NAME] のところへ遊びに来ました。\nメニューの操作は [PLAYER1_NAME] が行います。\n通信品質は自分と相手との通信環境に依存します。
SYS_DIALOG_DURING_GUEST_OPERATION_TEXT	[OWNER_NAME] が操作しています。
SYS_DIALOG_DURING_HOST_OPERATION_TEXT	[PLAYER1_NAME] が操作しています。
SYS_DIALOG_LAUNCHING_ANOTHER_ONE	[2P_NAME] の本体では別のタイトルが起動します。\n（[2P_NAME] が操作してください）
SYS_DIALOG_LAUNCHING_OTHERS_ONE	[2P_NAME] の本体ではどのタイトルを起動しますか？\n（[2P_NAME] が操作してください）
SYS_DIALOG_LAUNCHING_OTHERS	[1P_NAME] 以外の本体ではどのタイトルを起動しますか？\n（[2P_NAME] が操作してください）
SYS_HUD_GUIDE_PRO_CONFIRM	[IMG_BUTTON_A]  決定
SYS_HUD_GUIDE_PRO_BACK	[IMG_BUTTON_B]  もどる
SYS_HUD_GUIDE_PRO_DETAILS	[IMG_BUTTON_X]  くわしく
SYS_HUD_GUIDE_PRO_MOVE	[IMG_BUTTON_Y]  移動
SYS_HUD_GUIDE_PRO_MOVE2	[IMG_BUTTON_Y]  移動　（長押しでソート）
SYS_HUD_GUIDE_PRO_SORT	[IMG_BUTTON_Y]  長押しでソート
SYS_HUD_GUIDE_PRO_PLAY	[IMG_BUTTON_A]  はじめる
SYS_HUD_GUIDE_PRO_GUIDE	[IMG_BUTTON_X]  操作ガイド
SYS_HUD_GUIDE_PRO_EXCHANGE	[IMG_BUTTON_Y]  1P/2P入れ替え
SYS_HUD_GUIDE_PRO_VOICE_CHAT	[IMG_BUTTON_X]  ボイスチャットするには？
SYS_HUD_GUIDE_PRO_INGAME_PAUSE	[IMG_BUTTON_ZL] + [IMG_BUTTON_ZR]  中断メニュー
SYS_HUD_GUIDE_PRO_INGAME_START	[IMG_BUTTON_PLUS]  STARTボタン
SYS_HUD_GUIDE_PRO_INGAME_SELECT	[IMG_BUTTON_MINUS]  SELECTボタン
SYS_HUD_GUIDE_PRO_INGAME_QUIT_ONLINE	[IMG_BUTTON_ZL] + [IMG_BUTTON_ZR]  オンラインプレイをやめる
SYS_HUD_GUIDE_PRO_INGAME_QUIT_WIRELESS	[IMG_BUTTON_ZL] + [IMG_BUTTON_ZR]  ローカル通信をやめる
SYS_HUD_GUIDE_PRO_DETAILES_NEXT	[IMG_BUTTON_A]  つぎへ
SYS_HUD_GUIDE_PRO_COMMIT	[IMG_BUTTON_Y]  確定
SYS_HUD_GUIDE_PRO_CANCEL	[IMG_BUTTON_B]  元にもどす
SYS_HUD_GUIDE_PRO_SINGLE_PAK	[IMG_BUTTON_MINUS]  1カートリッジプレイ
SYS_HUD_GUIDE_PRO_MULTI_PAK	[IMG_BUTTON_MINUS]  マルチカートリッジプレイ
SYS_HUD_GUIDE_JOY_L_SINGLE_PAK	[IMG_BUTTON_MINUS]  1カートリッジプレイ
SYS_HUD_GUIDE_JOY_L_MULTI_PAK	[IMG_BUTTON_MINUS]　マルチカートリッジプレイ
SYS_HUD_GUIDE_JOY_R_SINGLE_PAK	[IMG_BUTTON_PLUS]  1カートリッジプレイ
SYS_HUD_GUIDE_JOY_R_MULTI_PAK	[IMG_BUTTON_PLUS]　マルチカートリッジプレイ
SYS_HUD_GUIDE_JOY_L_CONFIRM	[IMG_BUTTON_CLOVER_R]  決定
SYS_HUD_GUIDE_JOY_R_CONFIRM	[IMG_BUTTON_CLOVER_R]  決定
SYS_HUD_GUIDE_JOY_L_BACK	[IMG_BUTTON_CLOVER_D]  もどる
SYS_HUD_GUIDE_JOY_R_BACK	[IMG_BUTTON_CLOVER_D]  もどる
SYS_HUD_GUIDE_JOY_L_DETAILS	[IMG_BUTTON_CLOVER_U]  くわしく
SYS_HUD_GUIDE_JOY_R_DETAILS	[IMG_BUTTON_CLOVER_U]  くわしく
SYS_HUD_GUIDE_JOY_L_MOVE	[IMG_BUTTON_CLOVER_L]  移動
SYS_HUD_GUIDE_JOY_L_MOVE2	[IMG_BUTTON_CLOVER_L]  移動　（長押しでソート）
SYS_HUD_GUIDE_JOY_L_SORT	[IMG_BUTTON_CLOVER_L]  長押しでソート
SYS_HUD_GUIDE_JOY_R_MOVE	[IMG_BUTTON_CLOVER_L]  移動
SYS_HUD_GUIDE_JOY_R_MOVE2	[IMG_BUTTON_CLOVER_L]  移動　（長押しでソート）
SYS_HUD_GUIDE_JOY_R_SORT	[IMG_BUTTON_CLOVER_L]  長押しでソート
SYS_HUD_GUIDE_JOY_L_PLAY	[IMG_BUTTON_CLOVER_R]  はじめる
SYS_HUD_GUIDE_JOY_R_PLAY	[IMG_BUTTON_CLOVER_R]  はじめる
SYS_HUD_GUIDE_JOY_L_GUIDE	[IMG_BUTTON_CLOVER_U]  操作ガイド
SYS_HUD_GUIDE_JOY_R_GUIDE	[IMG_BUTTON_CLOVER_U]  操作ガイド
SYS_HUD_GUIDE_JOY_L_EXCHANGE	[IMG_BUTTON_CLOVER_L]  1P/2P入れ替え
SYS_HUD_GUIDE_JOY_R_EXCHANGE	[IMG_BUTTON_CLOVER_L]  1P/2P入れ替え
SYS_HUD_GUIDE_JOY_L_VOICE_CHAT	[IMG_BUTTON_CLOVER_U]  ボイスチャットするには？
SYS_HUD_GUIDE_JOY_R_VOICE_CHAT	[IMG_BUTTON_CLOVER_U]  ボイスチャットするには？
SYS_HUD_GUIDE_JOY_L_INGAME_PAUSE	[IMG_BUTTON_MINUS] + [IMG_BUTTON_ZL]  中断メニュー
SYS_HUD_GUIDE_JOY_R_INGAME_PAUSE	[IMG_BUTTON_PLUS] + [IMG_BUTTON_ZR]  中断メニュー
SYS_HUD_GUIDE_JOY_L_INGAME_START	[IMG_BUTTON_MINUS] + [IMG_BUTTON_SR]  STARTボタン
SYS_HUD_GUIDE_JOY_R_INGAME_START	[IMG_BUTTON_PLUS] + [IMG_BUTTON_SR]  STARTボタン
SYS_HUD_GUIDE_JOY_L_INGAME_SELECT	[IMG_BUTTON_MINUS] + [IMG_BUTTON_SL]  SELECTボタン
SYS_HUD_GUIDE_JOY_R_INGAME_SELECT	[IMG_BUTTON_PLUS] + [IMG_BUTTON_SL]  SELECTボタン
SYS_HUD_GUIDE_JOY_L_INGAME_QUIT_ONLINE	[IMG_BUTTON_MINUS] + [IMG_BUTTON_ZL]  オンラインプレイをやめる
SYS_HUD_GUIDE_JOY_L_INGAME_QUIT_WIRELESS	[IMG_BUTTON_MINUS] + [IMG_BUTTON_ZL]  ローカル通信をやめる
SYS_HUD_GUIDE_JOY_R_INGAME_QUIT_ONLINE	[IMG_BUTTON_PLUS] + [IMG_BUTTON_ZR]  オンラインプレイをやめる
SYS_HUD_GUIDE_JOY_R_INGAME_QUIT_WIRELESS	[IMG_BUTTON_PLUS] + [IMG_BUTTON_ZR]  ローカル通信をやめる
SYS_HUD_GUIDE_JOY_L_DETAILS_NEXT	[IMG_BUTTON_CLOVER_R]  つぎへ
SYS_HUD_GUIDE_JOY_R_DETAILS_NEXT	[IMG_BUTTON_CLOVER_R]  つぎへ
SYS_HUD_GUIDE_JOY_L_COMMIT	[IMG_BUTTON_CLOVER_L]  確定
SYS_HUD_GUIDE_JOY_R_COMMIT	[IMG_BUTTON_CLOVER_L]  確定
SYS_HUD_GUIDE_JOY_L_CANCEL	[IMG_BUTTON_CLOVER_D]  元にもどす
SYS_HUD_GUIDE_JOY_R_CANCEL	[IMG_BUTTON_CLOVER_D]  元にもどす
SYS_HUD_GUIDE_PRO_TOGGLE_SCREEN_SHARE	[IMG_BUTTON_A]  画面を見せる/かくす
SYS_HUD_GUIDE_JOY_L_TOGGLE_SCREEN_SHARE	[IMG_BUTTON_CLOVER_R]  画面を見せる/かくす
SYS_HUD_GUIDE_JOY_R_TOGGLE_SCREEN_SHARE	[IMG_BUTTON_CLOVER_R]  画面を見せる/かくす
SYS_HUD_GUIDE_PRO_INGAME_PAUSE_WITH_SCREENSHARE	[IMG_BUTTON_ZL] + [IMG_BUTTON_ZR]  中断メニュー（長押しで画面を見せる）
SYS_HUD_GUIDE_JOY_L_INGAME_PAUSE_WITH_SCREENSHARE	[IMG_BUTTON_MINUS] + [IMG_BUTTON_ZL]  中断メニュー（長押しで画面を見せる）
SYS_HUD_GUIDE_JOY_R_INGAME_PAUSE_WITH_SCREENSHARE	[IMG_BUTTON_PLUS] + [IMG_BUTTON_ZR]  中断メニュー（長押しで画面を見せる）
SYS_INFO_NICKNAME_OWN	[OWN_NAME]
SYS_INFO_NICKNAME_PLAYER1	[PLAYER1_NAME]
SYS_INFO_NICKNAME_PLAYER2	[PLAYER2_NAME]
SYS_INFO_SESSION_PASSWORD	[PASSWORD]
SYS_MENU_ROOT_SESSION_COUNTER	[NUMBER_OF_SESSIONS]
SYS_MENU_ONLINE_ITEM_SESSION1	[ROOM1]
SYS_MENU_ONLINE_ITEM_SESSION2	[ROOM2]
SYS_MENU_ONLINE_ITEM_SESSION3	[ROOM3]
SYS_MENU_ONLINE_ITEM_SESSION4	[ROOM4]
SYS_MENU_ONLINE_ITEM_SESSION5	[ROOM5]
SYS_MENU_ONLINE_ITEM_SESSION6	[ROOM6]
SYS_MENU_ONLINE_DESC_SESSION_LIST	一緒に遊ぶフレンドを選びます　[IMG_BUTTON_Y] 再検索
SYS_MENU_WIRELESS_DESC_SESSION_LIST	一緒に遊ぶ相手を選びます　[IMG_BUTTON_Y] 再検索
SYS_MENU_ONLINE_DESC_SESSION_LIST_JOY_L	一緒に遊ぶフレンドを選びます　[IMG_BUTTON_CLOVER_L] 再検索
SYS_MENU_WIRELESS_DESC_SESSION_LIST_JOY_L	一緒に遊ぶ相手を選びます　[IMG_BUTTON_CLOVER_L] 再検索
SYS_MENU_ONLINE_DESC_SESSION_LIST_JOY_R	一緒に遊ぶフレンドを選びます　[IMG_BUTTON_CLOVER_L] 再検索
SYS_MENU_WIRELESS_DESC_SESSION_LIST_JOY_R	一緒に遊ぶ相手を選びます　[IMG_BUTTON_CLOVER_L] 再検索
SYS_MENU_ONLINE_DESC_SESSION_LIST_INVITE	合流するフレンドを選びます　[IMG_BUTTON_Y] 再検索
SYS_MENU_WIRELESS_DESC_SESSION_LIST_INVITE	合流する相手を選びます　[IMG_BUTTON_Y] 再検索
SYS_MENU_ONLINE_DESC_SESSION_LIST_JOY_L_INVITE	合流するフレンドを選びます　[IMG_BUTTON_CLOVER_L] 再検索
SYS_MENU_ONLINE_DESC_SESSION_LIST_JOY_R_INVITE	合流するフレンドを選びます　[IMG_BUTTON_CLOVER_L] 再検索
SYS_MENU_DETAILS_DESC_RELEASE_INFO	[DETAILED_COMPANY]　　[DETAILED_RELEASE_YEAR]年発売
SYS_MENU_DETAILS_DESC_PLAY_INFO_LONG_TIME	プレイ人数：[DETAILED_PLAYERS]人　　プレイ時間：[DETAILED_PLAYTIME]時間[DETAILED_PLAYTIME_MIN]分
SYS_MENU_DETAILS_DESC_PLAY_INFO_SHORT_TIME	プレイ人数：[DETAILED_PLAYERS]人　　プレイ時間：[DETAILED_PLAYTIME_MIN]分
SYS_MENU_DETAILS_DESC_PLAY_INFO_NO_TIME	プレイ人数：[DETAILED_PLAYERS]人
SYS_MENU_DETAIL_PAGE	[DETAIL_NOW_PAGE] / [DETAIL_ALL_PAGE]
SYS_MENU_SAVESLOT_ITEM_EMPTY	セーブデータ[SAVE_INDEX]
SYS_MENU_SAVESLOT_ITEM_VALID	セーブデータ[SAVE_INDEX]\n[SAVE_YEAR]/[SAVE_MONTH]/[SAVE_DAY] [SAVE_HOUR]:[SAVE_MINUTE]
SYS_MENU_SPECIAL2_TEXT	SPECIAL [NUMBER]
SYS_MENU_FRIENDPRESENCE	プレイ中のゲーム ： [FRIENDPRESENCE_TITLENAME]
SYS_NOTIFICATION_OTHER_PLAYER_MISSING_TEXT	[LEAVER_NAME] との通信が切断されました。\n引き続き遊びながらフレンドを待ちます。
SYS_NOTIFICATION_OTHER_PLAYER_MISSING_TEXT_WIRELESS	[LEAVER_NAME] との通信が切断されました。\n引き続き遊びながら相手を待ちます。
SYS_NOTIFICATION_OTHER_PLAYER_MISSING_TEXT_GUEST	[LEAVER_NAME] との通信が切断されました。
SYS_NOTIFICATION_OTHER_PLAYER_MISSING2_TEXT	[PLAYER1_NAME] との通信が切断されました。
SYS_NOTIFICATION_OPERATION_DENIED_TEXT	[PLAYER1_NAME] が操作しています。
SYS_POPUP_GUIDE_PRO_CONTROLLER_SELECT	カーソルを移動させるには\n[IMG_BUTTON_MINUS] ボタン
SYS_POPUP_GUIDE_PRO_CONTROLLER_START	ゲームをスタートするには\n[IMG_BUTTON_PLUS] ボタン
SYS_POPUP_GUIDE_JOY_L_CONTROLLER_SELECT	カーソルを移動させるには\n[IMG_BUTTON_MINUS] + [IMG_BUTTON_SL]
SYS_POPUP_GUIDE_JOY_L_CONTROLLER_START	ゲームをスタートするには\n[IMG_BUTTON_MINUS] + [IMG_BUTTON_SR]
SYS_POPUP_GUIDE_JOY_R_CONTROLLER_SELECT	カーソルを移動させるには\n[IMG_BUTTON_PLUS] + [IMG_BUTTON_SL]
SYS_POPUP_GUIDE_JOY_R_CONTROLLER_START	ゲームをスタートするには\n[IMG_BUTTON_PLUS] + [IMG_BUTTON_SR]
SYS_POPUP_GUIDE_PRO_PAUSE_MENU	ゲームを中断するには [IMG_BUTTON_ZL] + [IMG_BUTTON_ZR]
SYS_POPUP_GUIDE_JOY_L_PAUSE_MENU	ゲームを中断するには [IMG_BUTTON_MINUS] + [IMG_BUTTON_ZL]
SYS_POPUP_GUIDE_JOY_R_PAUSE_MENU	ゲームを中断するには [IMG_BUTTON_PLUS] + [IMG_BUTTON_ZR]
SYS_POPUP_GUIDE_PRO_SWAP_PLAYERS	1P/2Pの入れ替えは、中断メニューで [IMG_BUTTON_Y] ボタン
SYS_POPUP_GUIDE_JOY_L_SWAP_PLAYERS	1P/2Pの入れ替えは、中断メニューで [IMG_BUTTON_CLOVER_L] ボタン
SYS_POPUP_GUIDE_JOY_R_SWAP_PLAYERS	1P/2Pの入れ替えは、中断メニューで [IMG_BUTTON_CLOVER_L] ボタン
SYS_POPUP_GUIDE_FINGER_CURSOR	[IMG_GAMEPAD_STICK_R] でおててカーソル、[IMG_BUTTON_STICK_R] （押し込み）で拍手
SYS_POPUP_GUIDE_FINGER_CURSOR_02	[IMG_GAMEPAD_STICK_R] でおててカーソル、[IMG_BUTTON_STICK_R] （押し込み）で拍手\nゲームプレイ中は出せません
SYS_POPUP_GUIDE_PRO_REWIND	ミスしても大丈夫。 [IMG_BUTTON_ZL] + [IMG_BUTTON_ZR] 長押しで巻き戻し。\n好きなところからやり直せます。
SYS_POPUP_GUIDE_JOY_L_REWIND	ミスしても大丈夫。 [IMG_BUTTON_MINUS] + [IMG_BUTTON_ZL] 長押しで巻き戻し。\n好きなところからやり直せます。
SYS_POPUP_GUIDE_JOY_R_REWIND	ミスしても大丈夫。 [IMG_BUTTON_PLUS] + [IMG_BUTTON_ZR] 長押しで巻き戻し。\n好きなところからやり直せます。
SYS_POPUP_GUIDE_PRO_SCREEN_SHARE	[IMG_BUTTON_ZL] + [IMG_BUTTON_ZR] 長押しでゲーム画面を共有できます。
SYS_POPUP_GUIDE_JOY_L_SCREEN_SHARE	[IMG_BUTTON_MINUS] + [IMG_BUTTON_ZL] 長押しでゲーム画面を共有できます。
SYS_POPUP_GUIDE_JOY_R_SCREEN_SHARE	[IMG_BUTTON_PLUS] + [IMG_BUTTON_ZR] 長押しでゲーム画面を共有できます。
SYS_HUD_GUIDE_PRO_INGAME_PAUSE_WITH_REWIND	[IMG_BUTTON_ZL] + [IMG_BUTTON_ZR]  中断メニュー（長押しで巻き戻し）
SYS_HUD_GUIDE_JOY_L_INGAME_PAUSE_WITH_REWIND	[IMG_BUTTON_MINUS] + [IMG_BUTTON_ZL]  中断メニュー（長押しで巻き戻し）
SYS_HUD_GUIDE_JOY_R_INGAME_PAUSE_WITH_REWIND	[IMG_BUTTON_PLUS] + [IMG_BUTTON_ZR]  中断メニュー（長押しで巻き戻し）
SYS_SORT_HEADING_PLAY_TIME	[VALUE]分
SYS_SORT_HEADING_DATE_PLAYED_1	[YEAR]/[MONTH]/[DAY]
SYS_SORT_HEADING_DATE_PLAYED_2	[MONTH]/[DAY]
SYS_USER_GUIDE_JOY_L_COMBINATION	[IMG_BUTTON_MINUS] + [IMG_BUTTON_SL] SELECT    [IMG_BUTTON_MINUS] + [IMG_BUTTON_SR] START
SYS_USER_GUIDE_JOY_R_COMBINATION	[IMG_BUTTON_PLUS] + [IMG_BUTTON_SL] SELECT    [IMG_BUTTON_PLUS] + [IMG_BUTTON_SR] START
SYS_USER_GUIDE_SYSTEM_HOME	[IMG_BUTTON_HOME] HOMEメニュー
SYS_USER_GUIDE_SYSTEM_CAPTURE	[IMG_BUTTON_CAPTURE] キャプチャー
SYS_USER_GUIDE_SYSTEM_CAPTURE2	キャプチャー [IMG_BUTTON_CAPTURE]
SYS_CONNECT_GUIDE_TITLE_HEADING	『[LOCALE_TITLE_NAME]』通信プレイのはじめかた
titles
C-3381_j	ゲームボーイギャラリー3
C-5928_j	ワリオランド3 不思議なオルゴール
C-3996_j	ゼルダの伝説 夢をみる島DX
D-7984_j	レッドアリーマー MAKAIMURA GAIDEN
D-5661_j	星のカービィ
D-1577_j	メトロイドII RETURN OF SAMUS
D-5124_j	スーパーマリオランド2 6つの金貨
D-8484_j	Tetris®
D-1504_j	役満
