traditional_chinese.txt
CREDIT_A_SUBTITLE_COMPANY_NAME_1	© Nintendo|Nintendo and Mercury Steam Entertainment are the authors of this software for the purpose of copyright. All rights reserved.|Nintendo et Mercury Steam Entertainment sont les auteurs de ce logiciel au regard du droit d'auteur. Tous droits réservés.
ERROR_CODE_2115-0080	請關閉飛航模式。||可以在快速設定（長按᠏鍵）更改。
ERROR_CODE_2115-0128	發生錯誤，||請再試一次。
ERROR_CODE_2115-0144	此amiibo的資料已損壞。||請嘗試以使用過此amiibo的遊戲主機復原資料，或是從HOME選單的᠏（設定）→「amiibo」初始化amiibo｡
ERROR_CODE_2115-0160	發生錯誤，||請再試一次。
ERROR_CODE_2115-0168	發生錯誤，||請再試一次。
ERROR_CODE_2115-0176	這不是amiibo。
ERROR_CODE_2115-0177	這不是amiibo。
ERROR_CODE_2115-0178	這不是amiibo。
ERROR_CODE_2115-0179	這不是amiibo。
ERROR_CODE_2115-0180	這不是amiibo。
ERROR_CODE_2115-0181	這不是amiibo。
ERROR_CODE_2115-0182	這不是amiibo。
ERROR_CODE_2115-0183	這不是amiibo。
ERROR_CODE_2115-0184	不支援此amiibo。
ERROR_CODE_2115-0192	發生錯誤，||請再試一次。
ERROR_CODE_2115-0200	發生錯誤，||請再試一次。
ERROR_CODE_2115-0064	請連接可以讀取amiibo的控制器。|透過有線通訊使用Nintendo Switch Pro控制器時，|請移除USB充電線後重新嘗試｡
APP_GAMEMODE_HARD	困難模式
APP_GAMEMODE_NORMAL	普通模式
GUI_AMIIBO_FTUE	只要掃描與密特羅德相關的amiibo，|就可強化薩姆斯，或是隨機回復資源。|相同amiibo的回復功能，一天只能使用一次。
GUI_AMIIBO_STATE_EFFECTS_APPLY_ALREADY_USED	今天已使用過此amiibo。
GUI_AMIIBO_STATE_EFFECTS_APPLY_AMMO_REFILL_PLUS_TANK	已獲得追加的導彈進階包，|持有上限增加10。
GUI_AMIIBO_STATE_EFFECTS_APPLY_ENERGY_REFILL_PLUS_TANK	已獲得追加的能量包，|能量上限增加100。
GUI_AMIIBO_STATE_EFFECTS_APPLY_AMMO_REFILL_1	已回復15枚導彈。
GUI_AMIIBO_STATE_EFFECTS_APPLY_AMMO_REFILL_2	已回復30枚導彈。
GUI_AMIIBO_STATE_EFFECTS_APPLY_AMMO_REFILL_3	已回復60枚導彈。
GUI_AMIIBO_STATE_EFFECTS_APPLY_ENERGY_REFILL_1	已回復50點能量。
GUI_AMIIBO_STATE_EFFECTS_APPLY_ENERGY_REFILL_2	已回復100點能量。
GUI_AMIIBO_STATE_EFFECTS_APPLY_ENERGY_REFILL_3	已回復200點能量。
GUI_AMIIBO_STATE_EFFECTS_ALREADY_AMMO_FILLED	導彈已滿，|無法適用此amiibo的回復效果。
GUI_AMIIBO_STATE_EFFECTS_ALREADY_ENERGY_FILLED	能量已滿，|無法適用此amiibo的回復效果。
GUI_AMIIBO_STATE_EFFECTS_APPLY_NOEFFECT	不支援此amiibo。
GUI_AMIIBO_STATE_EFFECTS_DISABLED_DAMAGE	受到傷害的期間，無法使用amiibo。
GUI_AMIIBO_STATE_EFFECTS_DISABLED_HYPERSUIT	在密特羅德服的狀態，無法使用amiibo。
GUI_AMIIBO_STATE_ERROR_READ	讀取amiibo的資料時發生錯誤。
GUI_AMIIBO_STATE_WAIT	請用amiibo點觸NFC範圍。
GUI_A_ACCEPT	᠀確定
GUI_A_ACCEPT_DEATH	᠀繼續
GUI_B_BACK	᠁取消
GUI_B_BACK_DEATH	᠁結束遊戲
GUI_B_CONFIRM	᠁確定
GUI_CONTROLS_LABEL_B	᠁跳躍
GUI_CONTROLS_LABEL_L	自由瞄準᠄
GUI_CONTROLS_LABEL_LEFT	展開迷你地圖᠓
GUI_CONTROLS_LABEL_LS	移動᠝
GUI_CONTROLS_LABEL_MINUS	選項᠊
GUI_CONTROLS_LABEL_PLUS	᠌地圖
GUI_CONTROLS_LABEL_R	᠅導彈模式
GUI_CONTROLS_LABEL_X	᠂近戰反擊
GUI_CONTROLS_LABEL_X_2	（奔跑時：衝刺近戰）
GUI_CONTROLS_LABEL_Y	᠃射擊
GUI_CONTROLS_LABEL_ZL	滑行᠆
GUI_DEATH_TITLE_GAMEOVER	GAME OVER
GUI_DEATH_TITLE_GAMEOVER_COUNTDOWN	逃脫失敗
GUI_DIFSELECTOR_LABEL_DESCRIPTOR_HARD_UNLOCKED	專為高手設計的模式
GUI_DIFSELECTOR_LABEL_DESCRIPTOR_NORMAL	一般難度的遊玩模式
GUI_DIFSELECTOR_LABEL_TITLE_DIFSELECT_1	檔案1 - 選擇難度
GUI_DIFSELECTOR_LABEL_TITLE_DIFSELECT_2	檔案2 - 選擇難度
GUI_DIFSELECTOR_LABEL_TITLE_DIFSELECT_3	檔案3 - 選擇難度
GUI_ENDING_CELEBRATION	See you next mission!
GUI_ENDING_CLEAR_TIME	CLEAR TIME
GUI_FILEEXTRAS_CREDITS	工作人員
GUI_FILEEXTRAS_GALLERY	畫廊
GUI_FILEEXTRAS_GALLERY_TITLE	畫廊
GUI_FILEEXTRAS_MISSION_LOG	任務記錄
GUI_FILEMENU_HEADER_1	檔案1
GUI_FILEMENU_HEADER_2	檔案2
GUI_FILEMENU_HEADER_3	檔案3
GUI_FILEMENU_LABEL_CONTINUE	繼續
GUI_FILEMENU_LABEL_EXTRAS	額外
GUI_FILEMENU_LABEL_NEW	新遊戲
GUI_FILEMENU_PROMPT_NEWCHOZOMEMORIES	畫廊已解鎖新內容。
GUI_FILEMENU_PROMPT_NEWGAME_CONFIRM_1	開始新遊戲將會刪除舊資料。||確定要繼續嗎？
GUI_FILEMENU_PROMPT_NEWGAME_CONFIRM_2	真的要刪除舊資料開始新遊戲嗎？
GUI_FILEMENU_PROMPT_NEWGAME_HEADER	開始新遊戲
GUI_FILESELECT_LABEL_EMPTYSLOT	空白資料
GUI_FILESELECT_LABEL_ITEMS	道具
GUI_FILESELECT_LABEL_TITLE_FILESELECT	SAMUS FILES
GUI_FILESELECT_OPTIONS_LABEL_COPY_EMPTY_1	複製至檔案1（空白）
GUI_FILESELECT_OPTIONS_LABEL_COPY_EMPTY_2	複製至檔案2（空白）
GUI_FILESELECT_OPTIONS_LABEL_COPY_EMPTY_3	複製至檔案3（空白）
GUI_FILESELECT_OPTIONS_LABEL_COPY_INUSE_1	複製至檔案1（使用中）
GUI_FILESELECT_OPTIONS_LABEL_COPY_INUSE_2	複製至檔案2（使用中）
GUI_FILESELECT_OPTIONS_LABEL_COPY_INUSE_3	複製至檔案3（使用中）
GUI_FILESELECT_OPTIONS_LABEL_DELETE	刪除資料
GUI_FILESELECT_OPTIONS_PROMPT_COPY_REPORT_OK	已成功複製檔案。
GUI_FILESELECT_OPTIONS_PROMPT_DELETE_CONFIRM_1	即將刪除檔案1的資料。||確定要刪除嗎？
GUI_FILESELECT_OPTIONS_PROMPT_DELETE_CONFIRM_2	即將刪除檔案2的資料。||確定要刪除嗎？
GUI_FILESELECT_OPTIONS_PROMPT_DELETE_CONFIRM_3	即將刪除檔案3的資料。||確定要刪除嗎？
GUI_FILESELECT_OPTIONS_PROMPT_DELETE_REPORT_OK	已成功刪除檔案。
GUI_FILESELECT_OPTIONS_PROMPT_OVWR_CONFIRM_1	檔案1已在使用中，||確定要覆蓋嗎？
GUI_FILESELECT_OPTIONS_PROMPT_OVWR_CONFIRM_2	檔案2已在使用中，||確定要覆蓋嗎？
GUI_FILESELECT_OPTIONS_PROMPT_OVWR_CONFIRM_3	檔案3已在使用中，||確定要覆蓋嗎？
GUI_FILESELECT_OPTIONS_PROMPT_SECOND_CONFIRM	注意：即將刪除儲存資料，||確定要繼續嗎？
GUI_FILESELECT_OPTIONS_TITLE_FILE_1	檔案1 - 選項
GUI_FILESELECT_OPTIONS_TITLE_FILE_2	檔案2 - 選項
GUI_FILESELECT_OPTIONS_TITLE_FILE_3	檔案3 - 選項
GUI_FILESELECT_PROMPT_HARDMODEUNLOCK	已解鎖困難模式。
GUI_GALLERY_BUTTON_HIDEUI	᠂隱藏顯示
GUI_GALLERY_CATEGORY_ENDING	過關獎勵
GUI_GALLERY_CATEGORY_ITEM	鳥人檔案
GUI_CHOZOARCHIVES_TITLE	鳥人檔案
GUI_GAMMA_LABEL_DESCRIPTION	請調整亮度，使左邊的圖隱約可見。|設定亮度可以在遊戲裡面的選項中更改。
GUI_GAMMA_LABEL_DESCRIPTION_OPTIONS	請調整亮度，使左邊的圖隱約可見。
GUI_GAMMA_LABEL_CONFIRM	確定要儲存目前的設定嗎？|也可在遊戲內的選項中調整亮度。
GUI_GAMMA_LABEL_CONFIRM_OPTIONS	確定要儲存設定嗎？
GUI_GENERAL_LABEL_ACCEPT	᠀確定
GUI_GENERAL_LABEL_BACK	᠁返回
GUI_GENERAL_LABEL_CANCEL	᠁取消
GUI_GENERAL_LABEL_CLOSE	᠌關閉
GUI_GENERAL_LABEL_OFF	關閉
GUI_GENERAL_LABEL_ON	開啟
GUI_GENERAL_LABEL_OPTIONS	選項
GUI_GENERAL_LABEL_UNKNOWN	？？？
GUI_LOG_EVENTS	᠆活動
GUI_LOG_TUTORIALS	教學᠇
GUI_MAPMENU_CUSTOMMARKER_LABEL_HEADER	剩餘記號數量
GUI_MAPMENU_CUSTOMMARKER_LABEL_REMOVE	移除
GUI_MAPMENU_CUSTOMMARKER_LABEL_REMOVEALL	᠂移除全部
GUI_MAPMENU_CUSTOMMARKER_WARNING_DELETE	確定要移除選擇的記號嗎？
GUI_MAPMENU_CUSTOMMARKER_WARNING_DELETEALL	確定要移除目前區域的所有記號嗎？
GUI_MAPMENU_LABEL_BACK	᠁返回
GUI_MAPMENU_LABEL_CHANGE_AREA	ᠯ更改地圖
GUI_MAPMENU_LABEL_CLOSE	᠁關閉
GUI_MAPMENU_LABEL_EMMIS_REMAINING	E.M.M.I.剩餘數量
GUI_MAPMENU_LABEL_FAST_MODE	ᠴ高速游標
GUI_MAPMENU_LABEL_GLOBAL_MAP	᠂全區地圖
GUI_MAPMENU_LABEL_ITEMS	道具
GUI_MAPMENU_LABEL_MOVE_MAP	ᠯ移動地圖
GUI_MAPMENU_LABEL_PLACE_MARKER	᠀設置記號
GUI_MAPMENU_LABEL_REMOVE_MARKER	᠀移除記號
GUI_MAPMENU_LABEL_RECENTER_SAMUS	ᠰ重設位置
GUI_MAPMENU_LABEL_SELECT_AREA	᠀選擇區域
GUI_MAPMENU_LABEL_ZOOM_IN_OUT	ᠷᠸ縮小/放大
GUI_MAPMENU_LABEL_NAVIGATION	導覽᠐
GUI_MAPMENU_LABEL_HIGHLIGHT_ICONS	᠃標記圖示
GUI_MAPMENU_LABEL_HIGHLIGHT_ICONS_DESELECT	᠃解除選擇
GUI_MAPMENU_LABEL_NAVIGATION_CLOSE	導覽᠕
GUI_MAPMENU_LABEL_SELECT_TELEPORT	請選擇目的地
GUI_MAPMENU_NOTIFY_FREE_TELEPORT	地圖上的傳送口已順利連接。
GUI_MAPMENU_LABEL_CONFIRM_TELEPORT	᠀確定目的地
GUI_MAPMENU_LABEL_CANCEL_TELEPORT	᠁取消
GUI_MAPMENU_LABEL_NO_TELEPORT	沒有可選擇的傳送口。
GUI_MAPMENU_TITLE	地圖
GUI_MISSIONLOG_TITLE	任務記錄
GUI_MSG_PRESS_START	請按下᠀鍵。
GUI_OPTIONS_LABEL_AMIIBO	amiibo
GUI_OPTIONS_LABEL_CONTROLS	操作
GUI_OPTIONS_LABEL_CONTROLS_TITLE	操作
GUI_OPTIONS_LABEL_GAMMA	設定亮度
GUI_OPTIONS_LABEL_GAMMA_TITLE	設定亮度
GUI_OPTIONS_LABEL_LOAD_LASTCP	讀取上一個檢查點
GUI_OPTIONS_LABEL_LOAD_LASTSAVE	讀取上次的儲存資料
GUI_OPTIONS_LABEL_QUIT	返回主選單
GUI_OPTIONS_LABEL_RUMBLE_OFF	震動（關閉）
GUI_OPTIONS_LABEL_RUMBLE_ON	震動（開啟）
GUI_OPTIONS_LABEL_SYSTEM	系統
GUI_OPTIONS_LABEL_SYSTEM_TITLE	系統
GUI_OPTIONS_PROMPT_LOAD_CHECKPOINT	若返回上一個檢查點，|將遺失未儲存的進度。|確定要繼續嗎？
GUI_OPTIONS_PROMPT_LOAD_SAVEGAME	若返回上次的儲存地點，|將遺失未儲存的進度。|確定要繼續嗎？
GUI_OPTIONS_PROMPT_QUIT	將遺失未儲存的進度。|確定要繼續嗎？
GUI_PLUS_BUTTON	᠌
GUI_PRESS_A	ᠩ
GUI_A_BUTTON	᠀
GUI_B_BUTTON	᠁
GUI_L_BUTTON	᠄
GUI_R_BUTTON	᠅
GUI_LEFT_STICK	᠝
GUI_R_STICK_PRESSED	ᠤ
GUI_ARROW_UP	ᠹ
GUI_ARROW_UP_BIG	ᡀ
GUI_ARROW_DOWN	ᠩ
GUI_ARROW_DOWN_BIG	ᡁ
GUI_SAMUSMENU_DESCR_BOMB	可在變形球狀態下使用的炸彈。||這個炸彈能對敵人造成傷害、破壞{c1}炸彈磚塊{c0}。若爆炸地點有隱藏磚塊，還可使{c1}隱藏磚塊現形{c0}。||薩姆斯在變形球狀態下，只要碰到爆炸波就會被彈開。||炸彈爆炸時的能量還可啟動{c1}變形球發射器{c0}。||在變形球狀態下按᠃鍵即可設置。
GUI_SAMUSMENU_DESCR_CHARGE_BEAM	集滿光束能量後就可一口氣發射。||蓄光束除了能對{c1}機器人類型的敵人跟BOSS{c0}造成傷害，|還可打開{c1}蓄光束門{c0}。||按住᠃鍵蓄力，再放開按鈕即可發射。||{c1}若在蓄滿能量的狀態下迴旋跳{c0}，將可使出蓄力攻擊。
GUI_SAMUSMENU_DESCR_DIFUSSION_CHARGE	蓄光束擊中目標時會引發大範圍的爆炸，爆炸威力可{c1}穿透地形{c0}。||按住᠃鍵蓄滿能量，再放開按鈕即可發射。
GUI_SAMUSMENU_DESCR_DOUBLE_JUMP	可在迴旋跳時{c1}再跳一次{c0}。||使出迴旋跳時，抓準時機再按一次᠁鍵即可發動。||在水中也能連跳，但若{c1}沒有重力服{c0}，就無法跳得比第一次高。
GUI_SAMUSMENU_DESCR_DOUBLE_JUMP_GRAVITY	可在迴旋跳時{c1}再跳一次{c0}。||使出迴旋跳時，抓準時機再按一次᠁鍵即可發動。
GUI_SAMUSMENU_DESCR_DOUBLE_JUMP_VARIA	可在迴旋跳時{c1}再跳一次{c0}。||使出迴旋跳時，抓準時機再按一次᠁鍵即可發動。||在水中也能連跳，但若{c1}沒有重力服{c0}，就無法跳得比第一次高。
GUI_SAMUSMENU_DESCR_GHOST_DASH	一種戰鬥用的艾翁能力，可瞬間朝左方或右方{c1}高速移動一段距離{c0}。||當艾翁全滿時，按住᠀鍵進入{c1}閃光轉移的準備狀態{c0}。|在此狀態下往左或往右推動᠝，即會快速移動到該方向。|推動᠝並同時按᠀也能發動。||{c1}在空中也可發動{c0}。||一旦發動閃光轉移，{c1}將會消耗所有艾翁{c0}。||發動閃光轉移後，只要馬上按住᠀鍵，|並在特定的時機再次往左或往右推動L操控搖桿，|{c1}即可再次發動閃光轉移{c0}，|最多可追加發動{c1}兩次{c0}。|再次發動的閃光轉移將不會消耗艾翁。
GUI_SAMUSMENU_DESCR_GRAPPLE_BEAM	發射線狀的光束後，即可連結{c1}發出藍色光芒的抓鉤點{c0}。||按住᠇鍵，再按下᠃鍵即可發射。||連結後，只要持續往反方向推動操控搖桿，就能拉動{c1}抓鉤光束門{c0}、{c1}抓鉤光束磚塊{c0}及{c1}抓鉤光束箱{c0}等等。||若連結{c1}磁板{c0}，薩姆斯就會移動至連結處。||若連結{c1}抓鉤擺動點{c0}，薩姆斯就可左右擺動。
GUI_SAMUSMENU_DESCR_GRAVITY_SUIT	可大幅減輕敵人造成的傷害，還能抵禦{c1}極寒地帶{c0}與{c1}熔岩{c0}帶來的傷害，|甚至可在水中行動自如。||此外，還能略為提升衝刺近戰的傷害。
GUI_SAMUSMENU_DESCR_HYPER_BEAM	薩姆斯覺醒後，透過潛在力量將手臂加農炮的能力合而為一。威力驚人的強力光束，可{c1}破壞一切{c0}。||按住᠃鍵即可發射。
GUI_SAMUSMENU_DESCR_ICE_MISSILE	追加{c1}凍結效果{c0}的導彈。||在按住᠅鍵的同時，按下᠃鍵即可發射。|此攻擊將會消耗1發導彈。
GUI_SAMUSMENU_DESCR_LINE_BOMB	會在設置處{c1}朝上下左右爆炸{c0}的強力炸彈。||在變形球狀態下，按住᠅鍵，再按下᠃鍵即可設置。
GUI_SAMUSMENU_DESCR_MISSILE	薩姆斯的手臂加農炮可發射的基本次要武器。||可對{c1}機器人類型的敵人跟BOSS{c0}造成傷害的高攻擊力導彈。||除了可破壞{c1}導彈磚塊{c0}跟{c1}導彈罩{c0}，若擊中地點有隱藏磚塊，還能使{c1}隱藏磚塊現形{c0}。||按住᠅鍵的同時，按下᠃鍵即可發射。|此攻擊將會消耗1發導彈。
GUI_SAMUSMENU_DESCR_MORPHBALL	可縮成一顆小球，|{c1}進入狹窄通道{c0}。||按下᠆鍵，或是在蹲下時|向下推動᠝操控搖桿即可變形。|只要在變形球狀態時，按下᠁鍵|{c1}即可跳躍{c0}。||{c1}如果是位置接近地面的狹窄通道{c0}，|只要朝通道方向|推動᠝並同時按᠁，|就會自動變成變形球進入通道。||此外，{c1}攀住狹窄通道時{c0}，|只要朝通道方向推動操控搖桿，|就會自動變成變形球進入通道。
GUI_SAMUSMENU_DESCR_MULTI_LOCK-ON_MISSILE	鎖定目標後，|即可連續發射多枚小型誘導導彈。||可同時攻擊多個被鎖定的目標，|{c1}亦對帶電進入無敵狀態的敵人有效{c0}。||此攻擊還可啟動{c1}暴風導彈箱{c0}。||按住᠅鍵完成蓄力後，|雷射將會轉為{c1}黃色{c0}。|被此雷射瞄準而鎖定的目標身上會出現鎖定記號。|鎖定記號最多可同時存在{c1}5個{c0}。|若在成功鎖定的狀態按下᠃鍵|就會發射多枚小型導彈。||每個鎖定標記|{c1}各會消耗3發導彈{c0}。
GUI_SAMUSMENU_DESCR_OPTICAL_CAMO	隱密行動專用的艾翁能力，可折射光線，讓{c1}薩姆斯進入透明狀態{c0}。|可在敵人的視野內隱形。|此外，移動速度雖會變慢，但{c1}移動時不會發出聲音{c0}。||艾翁全滿時，利用ᠴ即可進入透明狀態。|在透明狀態下，利用ᠴ即可解除透明狀態。||進入透明狀態時，將{c1}持續消耗艾翁{c0}。|若是在透明狀態下移動或射擊，將會消耗許多艾翁。|艾翁歸0時，若繼續維持透明狀態，將會{c1}持續消耗HP{c0}。|一旦HP變為1，將會自動解除透明狀態。||{c1}透明狀態解除後，只要展開行動{c0}，就會自動回復艾翁。|{c1}直到艾翁全滿後才可再次發動此能力{c0}。
GUI_SAMUSMENU_DESCR_PLASMA_BEAM	集中等離子能量的強大光束，{c1}可貫穿多個敵人{c0}。不須蓄力，即可對機器人類型的敵人造成傷害。||此外，還可破壞{c1}等離子光束罩{c0}。||按下᠃鍵即可發射。
GUI_SAMUSMENU_DESCR_POWER_BEAM	薩姆斯的手臂加農炮可發射的基本光束。||按下᠃鍵即可發射。|只要連按᠃鍵，就能連續射擊。
GUI_SAMUSMENU_DESCR_POWER_BOMB	威力非常強大的炸彈，會{c1}釋放驚人的熱能造成大範圍爆炸{c0}。||可破壞{c1}重磅炸彈磚塊{c0}。||在變形球狀態下按住᠅鍵，蓄滿能量後即可按下᠃鍵設置。|需消耗一顆重磅炸彈。
GUI_SAMUSMENU_DESCR_POWER_SUIT	薩姆斯的基本服裝。
GUI_SAMUSMENU_DESCR_SCREW_ATTACK	使出迴旋跳時，身上會包覆一層超強能量，可{c1}衝撞{c0}敵人造成傷害。||對{c1}帶電進入無敵狀態的敵人{c0}有效。||此外，還可破壞{c1}團身旋擊磚塊{c0}。
GUI_SAMUSMENU_DESCR_SONAR	探索用的艾翁能力，能發出特殊的音波{c1}掃描周圍的環境{c0}。|可偵測到隱藏磚塊的位置。||當艾翁全滿，只要按住᠒鍵即可發動。||脈衝雷達發動時，{c1}將會消耗所有的艾翁{c0}。
GUI_SAMUSMENU_DESCR_SPACE_JUMP	可在空中{c1}連續跳躍{c0}。||使出迴旋跳時，抓準時機再按一次᠁鍵即可在空中跳躍。||在水中也能連跳，但若{c1}沒有重力服{c0}，就無法跳得比第一次高。
GUI_SAMUSMENU_DESCR_SPACE_JUMP_GRAVITY	可在空中{c1}連續跳躍{c0}。||使出迴旋跳時，抓準時機再按一次᠁鍵即可在空中跳躍。
GUI_SAMUSMENU_DESCR_SPACE_JUMP_VARIA	可在空中連續跳躍。||使出迴旋跳時，抓準時機再按一次᠁鍵即可在空中跳躍。||在水中也能連跳，但若{c1}沒有重力服{c0}，就無法跳得比第一次高。
GUI_SAMUSMENU_DESCR_SPEED_BOOSTER	可在助跑後，以超高速持續奔跑。||效果發動時，只要衝撞敵人即可造成傷害，|還可破壞{c1}加速器磚塊{c0}。||奔跑的同時按下᠝，|即會進入{c1}加速器的準備狀態{c0}。|持續奔跑一定距離後，|就會發動加速器。||此外，加速器發動時，|還可使用{c1}能朝固定方向持續直線飛行{c0}的鳳凰之舞。||加速器發動時，往下推動᠝，|即會進入{c1}鳳凰之舞的準備狀態{c0}。|只要於此狀態按下᠁鍵，|啟動後再往想飛行的方向推動᠝，|便會發動鳳凰之舞。
GUI_SAMUSMENU_DESCR_SPIDER_MAGNET	可透過磁力攀住{c1}有藍色磁板的牆壁或天花板{c0}。||只要推動᠝操控搖桿並接觸有磁板的牆壁或天花板，就可攀住磁板。|可在攀住時{c1}移動或攻擊{c0}。|攀住天花板時，只要持續往上推動L操控搖桿，就可{c1}貼在天花板{c0}上。
GUI_SAMUSMENU_DESCR_SUPER_MISSILE	{c1}進一步強化攻擊力{c0}的導彈。||可破壞{c1}超級導彈罩{c0}。||按住᠅鍵的同時，按下᠃鍵即可發射。|此攻擊將會消耗1發導彈。
GUI_SAMUSMENU_DESCR_VARIA_SUIT	可減輕敵人造成的傷害，還能抵禦{c1}高溫地帶{c0}的傷害。|不過，會受到{c1}極寒地帶{c0}跟{c1}熔岩{c0}帶來的傷害。||此外，還能略為提升衝刺近戰的傷害。
GUI_SAMUSMENU_DESCR_WAVE_BEAM	可發射波動能量，{c1}貫穿地形與障礙物{c0}的光束。||此外，還可破壞{c1}波動光束罩{c0}。||按下᠃鍵即可發射。
GUI_SAMUSMENU_DESCR_WIDE_BEAM	一次可發射三道光束。||此外，還可移動{c1}寬光束箱{c0}及破壞{c1}寬光束罩{c0}。||按下᠃即可發射。
GUI_SAMUSMENU_DESCR_HYPER_SUIT	薩姆斯體內的密特羅德DNA失控後，樣貌已變得與密特羅德一樣。
GUI_SAMUSMENU_NAME_BOMB	炸彈
GUI_SAMUSMENU_NAME_CHARGE_BEAM	蓄光束
GUI_SAMUSMENU_NAME_DIFUSSION_CHARGE	散射光束
GUI_SAMUSMENU_NAME_DOUBLE_JUMP	旋轉推進
GUI_SAMUSMENU_NAME_GHOST_DASH	閃光轉移
GUI_SAMUSMENU_NAME_GRAPPLE_BEAM	抓鉤光束
GUI_SAMUSMENU_NAME_GRAVITY_SUIT	重力服
GUI_SAMUSMENU_NAME_HYPER_BEAM	強力光束
GUI_SAMUSMENU_NAME_ICE_MISSILE	冰凍導彈
GUI_SAMUSMENU_NAME_LINE_BOMB	十字炸彈
GUI_SAMUSMENU_NAME_MISSILE	導彈
GUI_SAMUSMENU_NAME_MORPHBALL	變形球
GUI_SAMUSMENU_NAME_MULTI_LOCKON_MISSILE	暴風導彈
GUI_SAMUSMENU_NAME_OPTICAL_CAMO	幻影斗篷
GUI_SAMUSMENU_NAME_PLASMA_BEAM	等離子光束
GUI_SAMUSMENU_NAME_POWER_BEAM	加強光束
GUI_SAMUSMENU_NAME_POWER_BOMB	重磅炸彈
GUI_SAMUSMENU_NAME_POWER_SUIT	普通服
GUI_SAMUSMENU_NAME_SCREW_ATTACK	團身旋擊
GUI_SAMUSMENU_NAME_SONAR	脈衝雷達
GUI_SAMUSMENU_NAME_SPACE_JUMP	連跳
GUI_SAMUSMENU_NAME_SPEED_BOOSTER	加速器
GUI_SAMUSMENU_NAME_SPIDER_MAGNET	蜘蛛磁鐵
GUI_SAMUSMENU_NAME_SUPER_MISSILE	超級導彈
GUI_SAMUSMENU_NAME_VARIA_SUIT	防護服
GUI_SAMUSMENU_NAME_WAVE_BEAM	波動光束
GUI_SAMUSMENU_NAME_WIDE_BEAM	寬光束
GUI_SAMUSMENU_NAME_HYPER_SUIT	密特羅德服
GUI_SAMUSMENU_SECTION_AEION	艾翁
GUI_SAMUSMENU_SECTION_BEAMS	光束
GUI_SAMUSMENU_SECTION_BOMBS	炸彈
GUI_SAMUSMENU_SECTION_MISC	其他
GUI_SAMUSMENU_SECTION_MISSILE	導彈
GUI_SAMUSMENU_SECTION_MORPHBALL	變形球
GUI_SAMUSMENU_SECTION_SUIT	服裝
GUI_SAMUSMENU_SHORTLABEL_BOMB	炸彈
GUI_SAMUSMENU_SHORTLABEL_CHARGE_BEAM	蓄光束
GUI_SAMUSMENU_SHORTLABEL_DIFUSSION_CHARGE	散射光束
GUI_SAMUSMENU_SHORTLABEL_DOUBLE_JUMP	旋轉推進
GUI_SAMUSMENU_SHORTLABEL_GHOST_DASH	閃光轉移
GUI_SAMUSMENU_SHORTLABEL_GRAPPLE_BEAM	抓鉤光束
GUI_SAMUSMENU_SHORTLABEL_GRAVITY_SUIT	重力服
GUI_SAMUSMENU_SHORTLABEL_HYPER_BEAM	強力光束
GUI_SAMUSMENU_SHORTLABEL_ICE_MISSILE	冰凍導彈
GUI_SAMUSMENU_SHORTLABEL_LINE_BOMB	十字炸彈
GUI_SAMUSMENU_SHORTLABEL_MISSILE	導彈
GUI_SAMUSMENU_SHORTLABEL_MORPHBALL	變形球
GUI_SAMUSMENU_SHORTLABEL_MULTI_LOCK-ON	暴風導彈
GUI_SAMUSMENU_SHORTLABEL_OPTICAL_CAMO	幻影斗篷
GUI_SAMUSMENU_SHORTLABEL_PLASMA_BEAM	等離子光束
GUI_SAMUSMENU_SHORTLABEL_POWER_BEAM	加強光束
GUI_SAMUSMENU_SHORTLABEL_POWER_BOMB	重磅炸彈
GUI_SAMUSMENU_SHORTLABEL_POWER_SUIT	普通服
GUI_SAMUSMENU_SHORTLABEL_SCREW_ATTACK	團身旋擊
GUI_SAMUSMENU_SHORTLABEL_SONAR	脈衝雷達
GUI_SAMUSMENU_SHORTLABEL_SPACE_JUMP	連跳
GUI_SAMUSMENU_SHORTLABEL_SPEED_BOOSTER	加速器
GUI_SAMUSMENU_SHORTLABEL_SPIDER_MAGNET	蜘蛛磁鐵
GUI_SAMUSMENU_SHORTLABEL_SUPER_MISSILE	超級導彈
GUI_SAMUSMENU_SHORTLABEL_VARIA_SUIT	防護服
GUI_SAMUSMENU_SHORTLABEL_WAVE_BEAM	波動光束
GUI_SAMUSMENU_SHORTLABEL_WIDE_BEAM	寬光束
GUI_SAMUSMENU_SHORTLABEL_HYPER_SUIT	密特羅德服
GUI_SAMUSMENU_TITLE	薩姆斯
GUI_SKIP_CINEMATIC	按下᠊鍵跳過
GUI_TITLE_LABEL_OPTIONS	᠊選項
GUI_TOTALRECHARGE_CANNOTUSE	武器和能量已滿
GUI_TOTALRECHARGE_SUCCESS	已全部回復
MAP_ICON_ACCESS_POINT	連接站
MAP_ICON_AMMO_STATION	武器站
MAP_ICON_BEAM_DOOR	光束門
MAP_ICON_CENTRALUNIT	中央單位
MAP_ICON_CENTRALUNIT_DOOR	中央單位門
MAP_ICON_CHARGE_BEAM_DOOR	蓄光束門
MAP_ICON_CHARGE_BEAM_DOOR_LOCKED	蓄光束門（關閉中）
MAP_ICON_CUSTOM_MARKER	記號
MAP_ICON_DOOR_CLOSED	禁止通行
MAP_ICON_DOOR_OPEN	開放通行
MAP_ICON_DOOR_LOCKED	光束門（關閉中）
MAP_ICON_ELEVATOR	電梯
MAP_ICON_EMMY	E.M.M.I.
MAP_ICON_EMMY_DOOR	E.M.M.I.區域門
MAP_ICON_EMMY_DOOR_CLOSED	E.M.M.I.區域門（關閉中）
MAP_ICON_EMMY_VALVE	E.M.M.I.閥
MAP_ICON_ENERGY_FRAGMENT	能量部件
MAP_ICON_ENERGY_STATION	能量站
MAP_ICON_ENERGY_TANK	能量包
MAP_ICON_GRAPPLE_BEAM_BLOCK	抓鉤光束磚塊
MAP_ICON_GRAPPLE_BEAM_BOX	抓鉤光束箱
MAP_ICON_GRAPPLE_BEAM_DOOR	抓鉤光束門
MAP_ICON_GRAPPLE_BEAM_POINT	抓鉤擺動點
MAP_ICON_GUNSHIP	宇宙艦艇
MAP_ICON_HYPER_BEAM_DOOR	強力光束門
MAP_ICON_INTERACTIVE_DEVICE	互動裝置
MAP_ICON_ACQUIRED_ITEM	已取得的道具
MAP_ICON_ACQUIRED_ITEM_FEMALE	
MAP_ICON_ITEM_CUBE	艾翁能力立方體
MAP_ICON_ITEM_CUBE_ACQUIRED	已取得的艾翁能力立方體
MAP_ICON_ITEM_SPHERE	能力球體
MAP_ICON_ITEM_SPHERE_ACQUIRED	已取得的能力球體
MAP_ICON_MAP_ROOM	地圖站
MAP_ICON_MISSILE_BLOCKAGE	導彈罩
MAP_ICON_MISSILE_TANK	導彈包
MAP_ICON_MISSILE_TANK_PLUS	導彈進階包
MAP_ICON_MORPHBALL_LAUNCHER	變形球發射器
MAP_ICON_MORPHBALL_LAUNCHER_EXIT	變形球發射器（出口）
MAP_ICON_MULTI_LOCK_TRAPDOOR	暴風導彈箱
MAP_ICON_PLASMA_BEAM_BLOCKAGE	等離子光束罩
MAP_ICON_POWERBOMB_TANK	重磅炸彈包
MAP_ICON_PRESENCE_DOOR	感知門
MAP_ICON_RAILWAY	穿梭器
MAP_ICON_SAMUS	薩姆斯
MAP_ICON_SAVE_ROOM	儲存站
MAP_ICON_SHUTTER	閘門
MAP_ICON_SHUTTER_PLATFORM	閘門平台
MAP_ICON_SUPER_MISSILE_BLOCKAGE	超級導彈罩
MAP_ICON_TELEPORT_STATION	傳送口
MAP_ICON_TELEPORT_STATION_A	傳送口（紅）
MAP_ICON_TELEPORT_STATION_E	傳送口（紫）
MAP_ICON_TELEPORT_STATION_I	傳送口（黃）
MAP_ICON_TELEPORT_STATION_O	傳送口（綠）
MAP_ICON_TELEPORT_STATION_U	傳送口（深藍）
MAP_ICON_TELEPORT_STATION_X	傳送口（藍）
MAP_ICON_TELEPORT_STATION_Y	傳送口（橘）
MAP_ICON_THERMAL_DOOR	熱能門
MAP_ICON_THERMAL_DOOR_CLOSED	熱能門（關閉中）
MAP_ICON_THERMAL_DOOR_OPEN	熱能門（開放中）
MAP_ICON_THERMAL_TRAP	熱能暗門
MAP_ICON_THERMAL_TRAP_CLOSED	熱能暗門（關閉中）
MAP_ICON_THERMAL_TRAP_OPEN	熱能暗門（開放中）
MAP_ICON_TOTAL_RECHARGE_STATION	總補給站
MAP_ICON_TRANSPORT_CAPSULE	運輸艙
MAP_ICON_UNKNOWN	？？？
MAP_ICON_WAVE_BEAM_BLOCKAGE	波動光束罩
MAP_ICON_WIDE_BEAM_BLOCKAGE	寬光束罩
MAP_ICON_WIDE_BEAM_BOX	寬光束箱
MAP_ICON_WIDE_BEAM_DOOR	寬光束門
MAP_ICON_BLOCK_BEAM	光束磚塊
MAP_ICON_BLOCK_BOMB	炸彈磚塊
MAP_ICON_BLOCK_MISSILE	導彈磚塊
MAP_ICON_BLOCK_PITFALL	陷阱磚塊
MAP_ICON_BLOCK_POWERBOMB	重磅炸彈磚塊
MAP_ICON_BLOCK_SCREW	團身旋擊磚塊
MAP_ICON_BLOCK_SPEED	加速器磚塊
MAP_ICON_WAR_LOTUS	恩基
MAP_ICON_BOSS	BOSS
MAP_ICON_BOSS_DEFEATED	擊敗的BOSS
MAP_ICON_PROP_OPEN	（解鎖中）
MAP_ICON_PROP_CLOSED	（關閉中）
MAP_ICON_BLOCK_DESTROYED	已破壞
MAP_ICON_BLOCK_DESTROYED_FEMALE	
MAP_ICON_DEVICE_USED	已使用
MAP_ICON_DEVICE_USED_FEMALE	
MAP_ICON_DOOR_FROZEN	凍結
MAP_ICON_DOOR_FROZEN_FEMALE	
GUI_COMPANY_TITLE_SCREEN	© Nintendo
MAP_STATE_BEGIN	（
MAP_STATE_END	）
MLOG_ABILITY_BOMB	在戴隆獲得{c1}炸彈{c0}
MLOG_ABILITY_CHARGE_BEAM	在阿爾塔利亞獲得{c1}蓄光束{c0}
MLOG_ABILITY_DIFFUSION_BEAM	在卡塔利斯獲得{c1}散射光束{c0}
MLOG_ABILITY_DOUBLE_JUMP	在賈柏藍獲得{c1}旋轉推進{c0}
MLOG_ABILITY_GHOST_AURA	在巴爾艾尼亞獲得{c1}閃光轉移{c0}
MLOG_ABILITY_GRAPPLE_BEAM	在阿爾塔利亞獲得{c1}抓鉤光束{c0}
MLOG_ABILITY_GRAVITY_SUIT	在巴爾艾尼亞獲得{c1}重力服{c0}
MLOG_ABILITY_HYPER_BEAM	在伊多拉修獲得{c1}強力光束{c0}
MLOG_ABILITY_HYPER_SUIT	在伊多拉修獲得{c1}密特羅德服{c0}
MLOG_ABILITY_ICE_MISSILE	在賈柏藍獲得{c1}冰凍導彈{c0}
MLOG_ABILITY_LINE_BOMB	在賈柏藍獲得{c1}十字炸彈{c0}
MLOG_ABILITY_MAGNET_GLOVE	在阿爾塔利亞獲得{c1}蜘蛛磁鐵{c0}
MLOG_ABILITY_MORPH_BALL	在卡塔利斯獲得{c1}變形球{c0}
MLOG_ABILITY_MULTILOCKON	在菲雷尼亞獲得{c1}暴風導彈{c0}
MLOG_ABILITY_OPTIC_CAMOUFLAGE	在阿爾塔利亞獲得{c1}幻影斗篷{c0}
MLOG_ABILITY_PLASMA_BEAM	在艾路恩獲得{c1}等離子光束{c0}
MLOG_ABILITY_POWER_BOMB	在哈奴比亞獲得{c1}重磅炸彈{c0}
MLOG_ABILITY_SCREW_ATTACK	在阿爾塔利亞獲得{c1}團身旋擊{c0}
MLOG_ABILITY_SONAR	在賈柏藍獲得{c1}脈衝雷達{c0}
MLOG_ABILITY_SPACE_JUMP	在菲雷尼亞獲得{c1}連跳{c0}
MLOG_ABILITY_SPEED_BOOSTER	在戴隆獲得{c1}加速器{c0}
MLOG_ABILITY_SUPER_MISSILE	在賈柏藍獲得{c1}超級導彈{c0}
MLOG_ABILITY_VARIA_SUIT	在阿爾塔利亞獲得{c1}防護服{c0}
MLOG_ABILITY_WAVE_BEAM	在菲雷尼亞獲得{c1}波動光束{c0}
MLOG_ABILITY_WIDE_BEAM	在戴隆獲得{c1}寬光束{c0}
MLOG_ADAM_AQUA	{c5}亞當的訊息{c0}（巴爾艾尼亞）᠀
MLOG_ADAM_CAVE	{c5}亞當的訊息{c0}（阿爾塔利亞）᠀
MLOG_ADAM_FOREST	{c5}亞當的訊息{c0}（賈柏藍）᠀
MLOG_ADAM_LAB	{c5}亞當的訊息{c0}（戴隆）᠀
MLOG_ADAM_MAGMA	{c5}亞當的訊息{c0}（卡塔利斯）᠀
MLOG_ADAM_SANC	{c5}亞當的訊息{c0}（菲雷尼亞）᠀
MLOG_ADAM_SHIP	{c5}亞當的訊息{c0}（哈奴比亞）᠀
MLOG_COOLDOWN_EVENT	行星的氣溫恢復正常了。
MLOG_DEFEAT_BOSS_2CRS_AQUA	在巴爾艾尼亞擊敗了{c3}機器鳥人士兵{c0}
MLOG_DEFEAT_BOSS_2CRS_SANC	在菲雷尼亞擊敗了{c3}機器鳥人士兵{c0}
MLOG_DEFEAT_BOSS_COMMANDER	在伊多拉修擊敗了{c3}雷文畢克{c0}
MLOG_DEFEAT_BOSS_COMMANDER_X	在哈奴比亞擊敗了{c3}雷文畢克X{c0}
MLOG_DEFEAT_BOSS_COOLDOWN_X	在卡塔利斯擊敗了{c3}實驗體 Z-57號{c0}
MLOG_DEFEAT_BOSS_CRS_FOREST	在賈柏藍擊敗了{c3}機器鳥人士兵{c0}
MLOG_DEFEAT_BOSS_CRS_SANC	在菲雷尼亞擊敗了{c3}機器鳥人士兵{c0}
MLOG_DEFEAT_BOSS_CWX_CAVE	在阿爾塔利亞擊敗了{c3}鳥人士兵{c0}
MLOG_DEFEAT_BOSS_CWX_FOREST	在賈柏藍擊敗了{c3}鳥人士兵{c0}
MLOG_DEFEAT_BOSS_CWX_QUARANTINE	在艾路恩擊敗了{c3}鳥人士兵{c0}
MLOG_DEFEAT_BOSS_CWX_SHIP	在哈奴比亞擊敗了{c3}鳥人士兵{c0}
MLOG_DEFEAT_BOSS_CWXE_SHIP	在哈奴比亞擊敗了{c3}菁英鳥人士兵{c0}
MLOG_DEFEAT_BOSS_HYDROGIGA	在巴爾艾尼亞擊敗了{c3}多羅基加{c0}
MLOG_DEFEAT_BOSS_KRAID	在卡塔利斯擊敗了{c3}克雷德{c0}
MLOG_DEFEAT_BOSS_SCORPIUS	在阿爾塔利亞擊敗了{c3}柯爾皮斯{c0}
MLOG_DEFEAT_BOSS_SUPER_GOLIATH	在賈柏藍擊敗了{c3}哥茲納{c0}
MLOG_DEFEAT_BOSS_SUPER_QUETZOA	在菲雷尼亞擊敗了{c3}艾司裘{c0}
MLOG_DEFEAT_EMMY_CAVE	在阿爾塔利亞破壞了{c3}E.M.M.I.-02SM{c0}
MLOG_DEFEAT_EMMY_FOREST	在賈柏藍破壞了{c3}E.M.M.I.-05IM{c0}
MLOG_DEFEAT_EMMY_LAB	在戴隆破壞了{c3}E.M.M.I.-04SB{c0}
MLOG_DEFEAT_EMMY_MAGMA	在卡塔利斯破壞了{c3}E.M.M.I.-03MB{c0}
MLOG_DEFEAT_EMMY_SANC	在菲雷尼亞破壞了{c3}E.M.M.I.-06WB{c0}
MLOG_DEFEAT_EMMY_SHIP	在哈奴比亞破壞了{c3}E.M.M.I.-07PB{c0}
MLOG_DEFEAT_PROTOEMMY_CAVE	在阿爾塔利亞破壞了{c3}E.M.M.I.-01P{c0}
MLOG_ENCOUNTER_EMMY_CAVE	在阿爾塔利亞遇見了{c3}E.M.M.I.-02SM{c0}
MLOG_ENCOUNTER_EMMY_FOREST	在賈柏藍的{c3}E.M.M.I.-05IM{c0}被啟動了
MLOG_ENCOUNTER_EMMY_LAB	在戴隆遇見了{c3}E.M.M.I.-04SB{c0}
MLOG_ENCOUNTER_EMMY_MAGMA	在卡塔利斯遇見了{c3}E.M.M.I.-03MB{c0}
MLOG_ENCOUNTER_EMMY_SANC	在菲雷尼亞遇見了{c3}E.M.M.I.-06WB{c0}
MLOG_ENCOUNTER_EMMY_SHIP	在哈奴比亞遇見了{c3}E.M.M.I.-07PB{c0}
MLOG_ENCOUNTER_PROTOEMMY_CAVE	在阿爾塔利亞遇見了{c3}E.M.M.I.-01P{c0}
MLOG_INIT	遇到不明的敵人
MLOG_PROFESSOR_ENCOUNTER	遇到魁特羅布᠀
MLOG_TUTO_SLIDING	{c1}滑行{c0}|推動᠝操控搖桿的同時按下᠆鍵即可滑行。
MLOG_TUTO_FREE_AIM	{c1}自由瞄準{c0}|按住᠄鍵進入自由瞄準模式。以᠝操控搖桿鎖定目標。
MLOG_TUTO_MISSILE_MODE	{c1}導彈模式{c0}|按住᠅鍵裝備導彈，按下᠃鍵發射。|部分磚塊僅能透過特定能力破壞。
MLOG_TUTO_HIDDEN_BLOCKS	{c1}隱藏磚塊{c0}|如果走到死路，就試著破壞周圍的地形吧。|有時會有磚塊被隱藏起來，以導彈攻擊便會現形。
MLOG_TUTO_BUTTON_MAP	{c1}地圖與選項{c0}|按下᠌鍵可以打開地圖畫面。|按下᠊鍵可以打開選項畫面。
MLOG_TUTO_MELEE	{c1}近戰反擊{c0}|在適當時機使出近戰反擊，即可躲避特定攻擊，|並且自動鎖定敵人。
MLOG_TUTO_MELEE_2	{c1}近戰反擊{c0}|擊敗受到近戰反擊而暈眩的敵人，|會掉落較多道具。
MLOG_TUTO_MELEE_3	{c1}近戰反擊{c0}|奔跑時按下᠂鍵便能使出威力強大的衝刺近戰。|不同於其他近戰反擊，衝刺近戰能對敵人造成傷害。
MLOG_TUTO_HINT	{c1}隱藏道具{c0}|地圖上閃爍的範圍裡有隱藏道具。
MLOG_TUTO_EMMY_GRAB	{c1}被E.M.M.I.捕獲時{c0}|唯有在閃光出現的同時按下᠂鍵能近戰反擊E.M.M.I.的攻擊。|但是在適當時機成功反擊的機率微乎其微。
MLOG_TUTO_EMMY_SLIDE	{c1}E.M.M.I.暈眩時{c0}|推動᠝操控搖桿的同時按下᠆鍵即可滑行。|透過滑行能從E.M.M.I.的下方通過。
MLOG_TUTO_MAP_ROOM	{c1}地圖{c0}|地圖上黃色的房間可以儲存檔案，|紫色的房間有可以移動至其他區域的穿梭器或電梯。
MLOG_TUTO_OMEGA_CANNON	{c1}鎖定聚焦模式{c0}|按下᠄鍵可進入鎖定聚焦模式。透過᠝操控搖桿輸入方向可瞄準敵人。|（若距離目標夠近，薩姆斯將自動轉至瞄準方向。）
MLOG_TUTO_OMEGA_BLASTER	{c1}歐米伽衝擊波{c0}|按住᠅鍵會替歐米伽衝擊波蓄力，|蓄滿的能量狀態下按住᠅鍵，同時按下᠃鍵瞄準核心發射衝擊波吧。
MLOG_TUTO_OMEGA_STREAM	{c1}歐米伽光線{c0}|按住᠃鍵以歐米伽光線照射，防護殼會發燙發紅。|一旦防護殼過熱，外殼將會損壞並露出核心。
MLOG_TUTO_OPTICAL_CAMO	{c1}幻影斗篷和E.M.M.I.{c0}|發動幻影斗篷的效果時，E.M.M.I.無法感應、辨識薩姆斯。|但請注意，一旦撞到E.M.M.I.將立即被捕獲。
MLOG_TUTO_PARASITE	{c1}寄生體X{c0}|打倒X擬態的敵人後，X將解除擬態並現形。|薩姆斯可以透過吸收X回復體力和導彈。
TERM_AREANAME_CAVES	ARTARIA
TERM_AREANAME_CAVES_SUBHEADER	阿爾塔利亞
TERM_AREANAME_CAVES_MAP_TITLE	阿爾塔利亞
TERM_AREANAME_CAVES_MAP_TRANSPORT	阿爾塔利亞
TERM_AREANAME_MAGMA	CATARIS
TERM_AREANAME_MAGMA_SUBHEADER	卡塔利斯
TERM_AREANAME_MAGMA_MAP_TITLE	卡塔利斯
TERM_AREANAME_MAGMA_MAP_TRANSPORT	卡塔利斯
TERM_AREANAME_LABORATORY	DAIRON
TERM_AREANAME_LABORATORY_SUBHEADER	戴隆
TERM_AREANAME_LABORATORY_MAP_TITLE	戴隆
TERM_AREANAME_LABORATORY_MAP_TRANSPORT	戴隆
TERM_AREANAME_AQUA	BURENIA
TERM_AREANAME_AQUA_SUBHEADER	巴爾艾尼亞
TERM_AREANAME_AQUA_MAP_TITLE	巴爾艾尼亞
TERM_AREANAME_AQUA_MAP_TRANSPORT	巴爾艾尼亞
TERM_AREANAME_FOREST	GHAVORAN
TERM_AREANAME_FOREST_SUBHEADER	賈柏藍
TERM_AREANAME_FOREST_MAP_TITLE	賈柏藍
TERM_AREANAME_FOREST_MAP_TRANSPORT	賈柏藍
TERM_AREANAME_QUARANTINE	ELUN
TERM_AREANAME_QUARANTINE_SUBHEADER	艾路恩
TERM_AREANAME_QUARANTINE_MAP_TITLE	艾路恩
TERM_AREANAME_QUARANTINE_MAP_TRANSPORT	艾路恩
TERM_AREANAME_SANCTUARY	FERENIA
TERM_AREANAME_SANCTUARY_SUBHEADER	菲雷尼亞
TERM_AREANAME_SANCTUARY_MAP_TITLE	菲雷尼亞
TERM_AREANAME_SANCTUARY_MAP_TRANSPORT	菲雷尼亞
TERM_AREANAME_SHIPYARD	HANUBIA
TERM_AREANAME_SHIPYARD_SUBHEADER	哈奴比亞
TERM_AREANAME_SHIPYARD_MAP_TITLE	哈奴比亞
TERM_AREANAME_SHIPYARD_MAP_TRANSPORT	哈奴比亞
TERM_AREANAME_SKYBASE	ITORASH
TERM_AREANAME_SKYBASE_SUBHEADER	伊多拉修
TERM_AREANAME_SKYBASE_MAP_TITLE	伊多拉修
TERM_AREANAME_SKYBASE_MAP_TRANSPORT	伊多拉修
TERM_CHARACTER_SAMUS	薩姆斯
TERM_CHARACTER_EMMY	E.M.M.I.
TERM_CHARACTER_PROFESSOR	魁特羅布
TERM_CHARACTER_COMMANDER	雷文畢克
TERM_CHARACTER_ADAM	亞當
TERM_BOSS_SCORPIUS	柯爾皮斯
TERM_BOSS_KRAID	克雷德
TERM_BOSS_HYDROGIGA	多羅基加
TERM_BOSS_SUPER_GOLIATH	哥茲納
TERM_BOSS_SUPER_QUETZOA	艾司裘
TERM_BOSS_CRS_SANC	機器鳥人士兵
TERM_BOSS_CRS_FOREST	機器鳥人士兵
TERM_BOSS_CRS_2_SANC	機器鳥人士兵 x 2
TERM_BOSS_CRS_2_AQUA	機器鳥人士兵 x 2
TERM_BOSS_CWX_QUARANTINE	鳥人士兵
TERM_BOSS_CWX_FOREST	鳥人士兵
TERM_BOSS_CWX_CAVE	鳥人士兵
TERM_BOSS_CWX_SHIPYARD	鳥人士兵
TERM_BOSS_CWX_ELITE	菁英鳥人士兵
TERM_BOSS_COOLDOWNX	實驗體 Z-57號
TERM_CHARACTER_COMMANDER_X	雷文畢克X
TIP_000_GENERAL_PARKOUR_000	{c6}跑酷||{c7}若只有1個磚塊的落差，奔跑即可自動跨越。{c0}
TIP_001_GENERAL_WALL_JUMP_000	{c6}蹬牆||{c7}迴旋跳時，於接觸牆壁的狀態下按᠁鍵就能蹬牆跳到反方向。{c0}
TIP_002_GENERAL_POWER_GRIP_000	{c6}強力攀握||{c7}跳躍或墜落的過程中，接觸到地形邊緣時朝該方向推動操控搖桿，薩姆斯即能抓住並攀在邊緣。{c0}
TIP_003_GENERAL_MELEE_COUNTER_000	{c6}近戰反擊||{c7}成功擊敗受到近戰反擊而暈眩的敵人時，會比平常掉落更大量的回復道具。{c0}
TIP_004_GENERAL_DASH_MELEE_000	{c6}衝刺近戰||{c7}奔跑時按下᠂鍵會變成衝刺近戰。衝刺近戰亦能對敵人造成傷害。{c0}
TIP_005_GENERAL_FREE_AIM_000	{c6}自由瞄準||{c7}在自由瞄準模式以雷射瞄準到敵人時，雷射光會變得更亮。{c0}
TIP_006_GENERAL_RUNNING_FREE_AIM_000	{c6}奔跑時自由瞄準||{c7}於奔跑時向斜上方或斜下方推動᠝操控搖桿，則不需停下也能改變射擊角度。{c0}
TIP_007_GENERAL_HIDDEN_BLOCKS_000	{c6}隱藏磚塊||{c7}地形中若藏有磚塊，以導彈攻擊便會現形。{c0}
TIP_008_GENERAL_HIDDEN_BLOCKS_001	{c6}隱藏磚塊||{c7}地形中若藏有磚塊，以導彈攻擊或是受到炸彈的爆炸波衝擊便會現形。{c0}
TIP_009_GENERAL_MISSILE_000	{c6}導彈||{c7}導彈雖有數量限制，但是個威力強大的攻擊方式。請積極使用吧。{c0}
TIP_010_GENERAL_CHARGE_BEAM_000	{c6}蓄光束||{c7}蓄光束能有效對免疫一般光束的敵人造成傷害。{c0}
TIP_011_GENERAL_CHARGE_BEAM_001	{c6}蓄光束||{c7}在蓄滿能量的狀態下使出迴旋跳會使出蓄力攻擊，能對接觸到的敵人造成傷害。{c0}
TIP_012_BOSS_BEAM_000	{c6}光束||{c7}不僅導彈和蓄光束，連射光束也能有效對麥歐金族造成傷害。{c0}
TIP_013_BOSS_BEAM_001	{c6}光束||{c7}不僅導彈和蓄光束，連射光束也是某些BOSS的弱點。{c0}
TIP_014_GENERAL_SPIDER_MAGNET_000	{c6}蜘蛛磁鐵||{c7}垂掛在天花板時，持續向上推動᠝操控搖桿就能貼在天花板上。較難被敵人發現或攻擊。{c0}
TIP_015_EMMI_ZONE_PHANTOM_CLOAK_000	{c6}幻影斗篷||{c7}發動後薩姆斯的身影和聲音會消失，不會被E.M.M.I.感應、辨識到。{c0}
TIP_016_EMMI_ZONE_PHANTOM_CLOAK_001	{c6}幻影斗篷||{c7}效果發動時，即使艾翁耗盡，也能消耗生命維持幻影斗篷的狀態。{c0}
TIP_017_GENERAL_PHANTOM_CLOAK_000	{c6}幻影斗篷||{c7}在E.M.M.I.區域以外的地方，也能不被敵人察覺繼續前進。{c0}
TIP_018_GENERAL_MORPH_BALL_000	{c6}變形球||{c7}要進入接近地面的變形球通道時，朝該方向推動᠝操控搖桿並按下᠁鍵，就能自動蜷成圓球並進入通道。{c0}
TIP_019_BOSS_FLASH_SHIFT_000	{c6}閃光轉移||{c7}能瞬間遠離或接近敵人，尤其在BOSS戰中相當實用。閃光轉移對難以避開的攻擊特別有效。{c0}
TIP_020_GENERAL_SPEED_BOOSTER_000	{c6}加速器||{c7}在加速器狀態下奔跑時，即使蹬牆跳躍或滑行都能維持加速狀態。{c0}
TIP_021_GENERAL_SPEED_BOOSTER_001	{c6}加速器||{c7}和一般奔跑時相同，薩姆斯在加速器狀態中也能自動跨越1個磚塊的落差。{c0}
TIP_022_GENERAL_SHINE_SPARK_000	{c6}鳳凰之舞||{c7}以鳳凰之舞移動時，撞到斜坡的瞬間，朝行進方向推動᠝，|將自動回到加速器狀態繼續奔跑。{c0}
TIP_023_GENERAL_BALL_SPARK_000	{c6}鳳凰球||{c7}在鳳凰之舞的準備狀態時，先轉為變形球再發動就會變成鳳凰球。{c0}
TIP_024_GENERAL_ICE_BREAKER_000	{c6}冰凍破擊||{c7}用近戰反擊可以直接破壞被冰凍導彈凍住的敵人。{c0}
TIP_025_GENERAL_CROSS_BOMB_000	{c6}十字炸彈||{c7}在變形球通道內，若能順利乘上十字炸彈的橫向爆炸波，便能順著爆炸波平行移動。{c0}
TIP_026_GENERAL_ICON_HIGHLIGHT_000	{c6}標記圖示||{c7}在地圖畫面將游標對準圖示按下᠃鍵會鎖定圖示。相同種類的圖示將在全地圖中被標記。{c0}
TIP_027_GENERAL_MAP_MARKERS_000	{c6}地圖記號||{c7}在地圖畫面按下᠀鍵可以設置記號。迷你地圖也會顯示記號，能夠幫助探索。{c0}
TIP_028_GENERAL_HIDDEN_ITEM_HINTS_000	{c6}隱藏道具提示||{c7}地圖上有閃爍白光的區域，這表示於該範圍內有隱藏道具。{c0}
TIP_029_GENERAL_ROOM_COLORS_000	{c6}房間顏色||{c7}地圖上黃色的房間可以儲存檔案，紫色的房間有可以移動至其他區域的穿梭器或電梯。{c0}
TIP_030_GENERAL_MINIMAP_RANGE_000	{c6}迷你地圖範圍||{c7}地圖畫面上的黃色框線為迷你地圖的顯示範圍。{c0}
TIP_031_EMMI_ZONE_EMMI_AND_THE_MINIMAP_000	{c6}迷你地圖上E.M.M.I.的位置||{c7}若E.M.M.I.進入迷你地圖範圍內，會以紅點表示。{c0}
TIP_032_GENERAL_EXPANDING_THE_MINIMAP_000	{c6}展開迷你地圖||{c7}在遊戲中按下᠓鍵能展開迷你地圖。執行任一操作迷你地圖即會恢復原狀。{c0}
TIP_033_GENERAL_SAMUS_SCREEN_000	{c6}薩姆斯畫面||{c7}在地圖畫面按下᠅鍵會切換至薩姆斯畫面，可在此確認薩姆斯各項能力的說明。{c0}
TIP_034_GENERAL_MISSION_LOG_SCREEN_000	{c6}任務記錄畫面||{c7}在地圖畫面按下᠄鍵可切換至任務記錄畫面，可在此回顧劇情及通訊室的通聯記錄。{c0}
TIP_035_GENERAL_OPTIONS_SCREEN_000	{c6}操作畫面||{c7}在遊戲中按下᠊鍵能打開操作畫面，可在此調整畫面亮度或讀取資料。{c0}
TIP_036_GENERAL_RECHARGE_STATIONS_000	{c6}補給站||{c7}補給站分為回復能量、回復武器和回復兩者三種類型。{c0}
TIP_037_EMMI_ZONE_EMMI_ZONE_DOORS_000	{c6}E.M.M.I.區域門||{c7}離開E.M.M.I.區域門後，會有數秒時間無法再次進入。{c0}
TIP_038_EMMI_ZONE_EMMI_ZONE_DOORS_001	{c6}E.M.M.I.區域門||{c7}被E.M.M.I.辨識並追擊時，所有門將暫時關閉。逃離E.M.M.I.的追擊範圍後將會再次開啟。{c0}
TIP_039_GENERAL_TRANSFER_PORTALS_000	{c6}傳送口||{c7}傳送口為兩個一組，使用後會被傳送到相同顏色的傳送口。{c0}
TIP_040_GENERAL_METROID_000	{c6}密特羅德||{c7}密特羅德是鳥人族為了驅逐X製造的人工生命體。{c0}
TIP_041_GENERAL_X_PARASITES_000	{c6}X||{c7}現今X的天敵密特羅德已全數滅絕，只剩下體內被注入了幼體密特羅德DNA的薩姆斯一人能對抗X。{c0}
TIP_042_GENERAL_X_PARASITES_001	{c6}X||{c7}X是在行星SR388上發現的寄生生命體，能寄生在任何生物。寄生後會殺死宿主，並複製其DNA擬態為該生物。{c0}
TIP_043_GENERAL_X_PARASITES_002	{c6}X||{c7}X也能寄生在生物的屍體上。於此情況下，X會根據遺留在屍體上的DNA擬態該生物生前的模樣。{c0}
TIP_044_GENERAL_X_PARASITES_003	{c6}X||{c7}若X經歷過多名宿主，則會擬態為融合各宿主特徵和外貌的新姿態。{c0}
TIP_045_EMMI_ZONE_EMMI_CAPTURE_000	{c6}E.M.M.I.的捕獲攻擊||{c7}雖有機會能逃離E.M.M.I.的捕獲攻擊，但時機相當難掌握，幾乎不可能成功。{c0}
TIP_046_EMMI_ZONE_EMMI_CAPTURE_001	{c6}E.M.M.I.的捕獲攻擊||{c7}若成功近戰反擊E.M.M.I.的捕獲攻擊，E.M.M.I.會暫時無法行動。|於此狀態時，可從E.M.M.I.下方滑行通過。{c0}
TIP_047_EMMI_ZONE_MAP_000	{c6}登錄地圖||{c7}首次進入E.M.M.I.區域時，會自動登錄區域的形狀和門的位置到地圖上。掌握門的位置與薩姆斯能否存活有緊密關聯。{c0}
TIP_048_EMMI_ZONE_PHANTOM_CLOAK_002	{c6}幻影斗篷||{c7}發動幻影斗篷只能讓E.M.M.I.無法感應、辨識薩姆斯，如果撞到E.M.M.I.仍會遭到捕獲。效果發動後就儘速移動到安全位置吧。{c0}
TIP_049_EMMI_ZONE_SPIDER_MAGNET_000	{c6}蜘蛛磁鐵||{c7}垂掛在天花板時，持續向上推動᠝操控搖桿就能貼在天花板上。搭配幻影斗篷使用還有機會能繞過E.M.M.I.。{c0}
TIP_050_EMMI_PHASE2_EMMI_CONFRONTATION_000	{c6}與E.M.M.I.對峙||{c7}E.M.M.I.透過感應歐米伽加農炮的能量，能準確鎖定薩姆斯的位置。{c0}
TIP_051_EMMI_PHASE2_EMMI_CONFRONTATION_001	{c6}和E.M.M.I.對峙||{c7}E.M.M.I.的弱點是頭部的核心，發射蓄滿能量的歐米伽衝擊波給E.M.M.I.致命一擊吧。{c0}
TIP_052_EMMI_PHASE2_EMMI_CONFRONTATION_002	{c6}和E.M.M.I.對峙||{c7}破壞E.M.M.I.頭部的防護殼後，不一定要馬上攻擊核心，也能根據戰況保持距離、重新調整狀態。{c0}
TIP_053_BOSS_BOSS_FIGHTS_000	{c6}若和BOSS陷入苦戰||{c7}世上沒有躲不掉的攻擊。仔細觀察，找出破口吧。{c0}
TIP_054_BOSS_GRAB_SEQUENCE_000	{c6}連續捕獲||{c7}部分BOSS會使出可近戰反擊的攻擊。|若成功近戰反擊，即是能以連續捕獲對敵人造成連續傷害的好機會。{c0}
TIP_055_BOSS_CHARGE_BEAM_000	{c6}蓄光束||{c7}除了導彈外，蓄光束也能有效對BOSS造成傷害。即便導彈用盡也千萬別放棄。{c0}
TIP_056_BOSS_FINISH_COUNTER_000	{c6}終結反擊||{c7}麥歐金族的敵人會在最後使出終結反擊。|看準時機近戰反擊，給予致命的一擊。{c0}
TIP_057_GENERAL_LOST_000	{c6}迷失探索方向||{c7}不知道有什麼新地點能去嗎？|這時候用地圖畫面的標記圖示功能並檢查任務記錄找出該走的路吧。{c0}
TIP_058_GENERAL_FLASH_SHIFT_000	{c6}閃光轉移||{c7}一般跳躍無法達成的橫向移動，在探索中也相當實用。連續發動閃光轉移還可高速移動。{c0}
TIP_059_GENERAL_EMMI_000	{c6}E.M.M.I.||{c7}E.M.M.I.的正式名稱為「行星外多形態機動調查機」。{c0}
CAVE_CENTRALUNIT_TUTO_CAMERA	按下᠄鍵可進入鎖定聚焦模式。透過᠝操控搖桿輸入方向可瞄準敵人。|（若距離目標夠近，薩姆斯將自動轉至瞄準方向。）
CAVE_CENTRALUNIT_TUTO_HEATING	按住᠃鍵以歐米伽光線照射，防護殼會發燙發紅。|一旦防護殼過熱，外殼將會損壞並露出核心。
CAVE_CENTRALUNIT_TUTO_SHOOT_MANUAL	按住᠅鍵會替歐米伽衝擊波蓄力，|蓄滿能量的狀態下按住᠅鍵，同時按下᠃鍵瞄準核心發射衝擊波吧。
CAVE_EMMY_PROTO_FLOOR_SLIDE_TUTO	推動᠝操控搖桿的同時按下᠆鍵即可滑行。|透過滑行能從E.M.M.I.的下方通過。
CAVE_EMMY_PROTO_GRAB_TUTO	唯有在閃光出現的同時按下᠂鍵能近戰反擊E.M.M.I.的攻擊。|但是在適當時機成功反擊的機率微乎其微。
CAVE_FREEAIM_TUTO	按住᠄鍵進入自由瞄準模式。以᠝操控搖桿鎖定目標。
CAVE_MELEE_CUTSCENE	在適當時機使出近戰反擊，即可躲避特定攻擊，|並且自動鎖定敵人。立刻按下᠂鍵近戰反擊吧！
CAVE_MISSILE_TUTO	按住᠅鍵裝備導彈，按下᠃鍵發射。|部分磚塊僅能透過特定能力破壞。
CAVE_SLIDING_TUTO	推動᠝操控搖桿的同時按下᠆鍵即可滑行。
CAVE_THERMAL_DOOR_MESSAGE	變更熱能的供給方向。
CAVE_HINT_TUTO	地圖上閃爍的範圍裡有隱藏道具。
CAVE_TUTO_MELEE_REMINDER	按下᠂鍵使出近戰反擊，時機恰當即可躲避攻擊。
CAVE_TUTO_MELEE_REMINDER_2	擊敗受到近戰反擊而暈眩的敵人，|會掉落較多道具。
CAVE_TUTO_MELEE_REMINDER_3	奔跑時按下᠂鍵便能使出威力強大的衝刺近戰。|不同於其他近戰反擊，衝刺近戰能對敵人造成傷害。
CAVE_TUTO_MAP_OPTIONS	按下᠌鍵可以打開地圖畫面。|按下᠊鍵可以打開選項畫面。
CAVE_TUTO_MAP_ROOM	地圖上黃色的房間可以儲存檔案，|紫色的房間有可以移動至其他區域的穿梭器或電梯。
QUARANTINE_TUTO_PARASITE	打倒X擬態的敵人後，X將解除擬態並現形。|薩姆斯可以透過吸收X回復體力和導彈。
GUI_AMMORECHARGE_CANNOTUSE	武器已滿。
GUI_ELEVATOR_QUESTION	要搭乘電梯嗎？
GUI_ENERGYRECHARGE_CANNOTUSE	能量已滿。
GUI_ITEM_ACQUIRED_BOMB	獲得炸彈了。
GUI_ITEM_ACQUIRED_CHARGE_BEAM	獲得蓄光束了。
GUI_ITEM_ACQUIRED_DIFFUSION_BEAM	獲得散射光束了。
GUI_ITEM_ACQUIRED_DOUBLE_JUMP	獲得旋轉推進了。
GUI_ITEM_ACQUIRED_GHOST_DASH	獲得閃光轉移了。
GUI_ITEM_ACQUIRED_GRAPPLE_BEAM	獲得抓鉤光束了。
GUI_ITEM_ACQUIRED_GRAVITY_SUIT	獲得重力服了。
GUI_ITEM_ACQUIRED_HYPER_BEAM	獲得強力光束了。
GUI_ITEM_ACQUIRED_ICE_MISSILE	獲得冰凍導彈了。
GUI_ITEM_ACQUIRED_LINE_BOMB	獲得十字炸彈了。
GUI_ITEM_ACQUIRED_MORPH_BALL	獲得變形球了。
GUI_ITEM_ACQUIRED_MULTI_LOCK	獲得暴風導彈了。
GUI_ITEM_ACQUIRED_OPTICAL_CAMO	獲得幻影斗篷了。
GUI_ITEM_ACQUIRED_PLASMA_BEAM	獲得等離子光束了。
GUI_ITEM_ACQUIRED_POWER_BOMB	獲得重磅炸彈了。
GUI_ITEM_ACQUIRED_SCREW_ATTACK	獲得團身旋擊了。
GUI_ITEM_ACQUIRED_SONAR	獲得脈衝雷達了。
GUI_ITEM_ACQUIRED_SPACE_JUMP	獲得連跳了。
GUI_ITEM_ACQUIRED_SPEED_BOOSTER	獲得加速器了。
GUI_ITEM_ACQUIRED_SPIDER_MAGNET	獲得蜘蛛磁鐵了。
GUI_ITEM_ACQUIRED_SUPER_MISSILE	獲得超級導彈了。
GUI_ITEM_ACQUIRED_VARIA_SUIT	獲得防護服了。
GUI_ITEM_ACQUIRED_WAVE_BEAM	獲得波動光束了。
GUI_ITEM_ACQUIRED_WIDE_BEAM	獲得寬光束了。
GUI_MAP_DOWNLOAD	已下載區域地圖。
GUI_SAVESTATION_QUESTION	要儲存檔案嗎？
GUI_TANK_ACQUIRED_ENERGY	獲得了能量包，|能量上限增加100。
GUI_TANK_ACQUIRED_ENERGY_FRAGMENT_1	獲得了能量部件(1/4)，|收集4個部件可增加能量上限。
GUI_TANK_ACQUIRED_ENERGY_FRAGMENT_2	獲得了能量部件(2/4)，|收集4個部件可增加能量上限。
GUI_TANK_ACQUIRED_ENERGY_FRAGMENT_3	獲得了能量部件(3/4)，|收集4個部件可增加能量上限。
GUI_TANK_ACQUIRED_ENERGY_FRAGMENT_COMPLETE	獲得了能量部件(4/4)，|能量上限增加100。
GUI_TANK_ACQUIRED_MISSILE	獲得了導彈包，|持有上限增加2。
GUI_TANK_ACQUIRED_MISSILE_PLUS	獲得了導彈進階包，|持有上限增加10。
GUI_TANK_ACQUIRED_POWER_BOMB	獲得了重磅炸彈包，|持有上限增加1。
GUI_TANK_ACQUIRED_UNKNOWN	獲得了不明道具，|目前無法使用此道具。
GUI_TELEPORT_QUESTION	要使用傳送口移動嗎？
GUI_TRANSPORT_AQUA	要前往巴爾艾尼亞嗎？
GUI_TRANSPORT_CAVE	要前往阿爾塔利亞嗎？
GUI_TRANSPORT_FOREST	要前往賈柏藍嗎？
GUI_TRANSPORT_LAB	要前往戴隆嗎？
GUI_TRANSPORT_MAGMA	要前往卡塔利斯嗎？
GUI_TRANSPORT_QUARANTINE	要前往艾路恩嗎？
GUI_TRANSPORT_SANC	要前往菲雷尼亞嗎？
GUI_TRANSPORT_SHIPYARD	要前往哈奴比亞嗎？
GUI_TRANSPORT_SKYBASE	要前往伊多拉修嗎？
GUI_ITEM_ACQUIRED_AEION	為了適應艾翁，正在升級服裝……
SKYBASE_ELEVATOR_COMMANDER	要搭乘電梯嗎？
CAVE_HIDDENBLOCKS_TUTO	如果走到死路，就試著破壞周圍的地形吧。|有時會有磚塊被隱藏起來，以導彈攻擊便會現形。
MAGMA_OPTICAL_TUTO	發動幻影斗篷的效果時，E.M.M.I.無法感應、辨識薩姆斯。|但請注意，一旦撞到E.M.M.I.將立即被捕獲。
GUI_OMEGA_CU_1	自中央單位注入的能量|使薩姆斯的手臂加農炮變形為歐米伽加農炮。
GUI_OMEGA_CU_2	可以使用「歐米伽衝擊波」。
GUI_OMEGA_CU_3	可以使用「歐米伽光線」。
GUI_OMEGA_EMMY_1	歐米伽加農炮變回手臂加農炮了。
CAPTION_PROLOGUE_PAGE_01	密特羅德：||鳥人族開發的浮游生命體。|這種可輕易繁殖的人工生命體，特性是只要透過物理接觸，|就可吸光生物等所有東西的能量，因而被當成生化武器，|曾經引發許多事件。|這個名稱在鳥人語有「最強戰士」之意，|但該生命體早已滅絕，不存於宇宙之中。
CAPTION_PROLOGUE_PAGE_02	X：||早已滅絕的凝膠狀寄生擬態生物，是行星SR388的特有種，|會滲透所有生物及屍體，或是侵入其中一部分，取得其基因後擬態。|若寄生的對象是活體，則會先連結宿主的記憶中樞獲取資訊，再使宿主死亡。|「X」不具有情感，僅是為了優先繁衍並保護後代|而基於本能反覆分裂、合體，擬態成更強的個體。|由於無法人為控制這種生命體，因此危險性更甚於其天敵密特羅德。
CAPTION_PROLOGUE_PAGE_03	密特羅德滅絕後，行星SR388變成了可怕的寄生擬態生物——X的巢穴。|我當時接下了銀河聯邦的委託，在一無所知的情況下進到行星SR388，|不料卻遭到X的寄生，面臨生死關頭。
CAPTION_PROLOGUE_PAGE_04	在注射了由X的天敵——密特羅德的DNA所提煉出的疫苗後，|我不僅保住性命，還成為世上唯一能對抗「X」的人。|後來我收到求救訊號，便前往了俗稱B.S.L.的BIOLOGIC宇宙生物研究所。
CAPTION_PROLOGUE_PAGE_05	當時X化為各種強敵，甚至模擬過去巔峰狀態的我，|擬態成「SA-X」與我決一死戰，在那場戰鬥中勝出後，|我便讓B.S.L.衝撞有無數X的SR388，連同星球一起把X消滅殆盡。
CAPTION_PROLOGUE_PAGE_06	隨著時間的流逝，人們逐漸淡忘了X與密特羅德，|但有一天銀河聯邦本部卻收到了一支影片。
CAPTION_PROLOGUE_PAGE_07	影片清楚拍到X在自然環境下活動的景象。
CAPTION_PROLOGUE_PAGE_08	經過分析後，我們不僅確定這支寄件人不明的影片並非偽造，|更鎖定了寄件的行星。
CAPTION_PROLOGUE_PAGE_09	那顆行星便是「ZDR」。假如早該滅絕的X真的棲息在那顆神秘星球上，|勢必將嚴重威脅銀河的和平。|因此，銀河聯邦便立即派遣由7台「E.M.M.I.」所組成的調查部隊前往ZDR。
CAPTION_PROLOGUE_PAGE_10	「E.M.M.I.」是一種專門用來捕獲未知生物及採集DNA的大型|調查機器人，其機動性非常優異，還是用宇宙最堅硬的特殊|材料所製成，因此派遣E.M.M.I.前往調查再合適不過了。
CAPTION_PROLOGUE_PAGE_11	然而，E.M.M.I.部隊抵達ZDR不久後便音訊全無。
CAPTION_PROLOGUE_PAGE_12	ZDR到底發生了什麼事？世上真的還有X嗎？|只有我這個擁有X抗體的人才能前往實地查明真相了。
CAPTION_INTRO_PAGE_1	即將進入ZDR的大氣層
CAPTION_INTRO_PAGE_2	這次的賞金不太合乎任務的難度
DISPLAY_ADAM_INTRO_PAGE_1	The bounty for this mission does not |seem appropriate.
CAPTION_INTRO_PAGE_3	風險明顯大於報酬
DISPLAY_ADAM_INTRO_PAGE_2	The risk clearly outweighs the reward.
CAPTION_INTRO_PAGE_4	小心別惹怒那些迷途羔羊了，女士
DISPLAY_ADAM_INTRO_PAGE_3	Treat our lost assets with care, Lady.
CAPTION_INTRO_PAGE_5	距離進入大氣層還有10秒，|9……8……7……6……5……4……3……2……1……
CAPTION_INTRO_FLASHBACK_PAGE_01	看來那座電梯會一路延伸到這個地下設施的深處，|恐怕是因為這樣……
CAPTION_INTRO_LANDING_PAGE_01	電波的訊號不太好，|今後很可能無法使用這個無線通訊。
CAPTION_INTRO_LANDING_PAGE_02	首先試著連接設施內的網路，|盡可能保持聯絡吧。
CAPTION_INTRO_LANDING_PAGE_03	你沒有異議吧，女士。
CAPTION_DATAUPLOAD_01	資料上傳中
DIAG_ADAM_CAVE_1_PAGE_1	薩姆斯，看來你成功連接通訊設施了，|我剛才已經查看你上傳的|{c1}生命資訊跟影片記錄{c0}了。
DIAG_ADAM_CAVE_1_PAGE_2	……透過這些資訊，我大致掌握你身上發生了什麼變化，|但我並不清楚你為何會失去意識，|只曉得你的生命資訊顯示你身上發生了鉅變。
DIAG_ADAM_CAVE_1_PAGE_3	在你承受不住壓力而失去意識時，你也失去了大部分的能力，|簡單說就是你忘記該如何使用能力。
DIAG_ADAM_CAVE_1_PAGE_4	我正在查詢聯邦資料庫，尋找襲擊你的凶手。|從影片來推斷應該是{c1}一種鳥人族{c0}，|但目前還無法斷定。
DIAG_ADAM_CAVE_1_PAGE_5	以目前這種情況來說，最好還是先回到地表的宇宙艦艇上，|不過我只能確定你目前人在{c1}ZDR的深處{c0}。|雖然危機四伏，但你只能靠自己{c1}回到地上{c0}了。
DIAG_ADAM_CAVE_1_PAGE_5_B	這個行星靠著穿梭器跟電梯連接了許多區域，|現在最好{c1}先朝這些運輸工具前進{c0}，|再逐步接近地表。
DIAG_ADAM_CAVE_1_PAGE_6	另外，宇宙艦艇的位置已經標在{c1}全區地圖{c0}上了，|等等記得查看一下。
DIAG_ADAM_CAVE_1_PAGE_6_B	還有一個移動時的提醒，|由於你體內有密特羅德的DNA，所以你跟密特羅德一樣不耐低溫，|依你現在的狀態，要是{c1}身處低溫環境將會持續受到傷害{c0}。
DIAG_ADAM_CAVE_1_PAGE_6_C	這個地下設施到處都有低溫區域，|切記不可{c1}穿著普通服{c0}進入低溫地帶。
DIAG_ADAM_CAVE_1_PAGE_7	地下設施會受到電波的干擾，因此{c1}無法使用無線通訊{c0}。|當你找到通訊設施時，記得一定要和我取得聯絡。
DIAG_ADAM_CAVE_2_PAGE_1	先前遇到的2隻E.M.M.I.顯然都把你當成捕獲的目標。|要是駭客已經竄改它們的系統，|我想{c1}所有的E.M.M.I.應該都會對你發動攻擊{c0}。
DIAG_ADAM_CAVE_2_PAGE_2	E.M.M.I.會發出{c1}特殊的脈衝波{c0}來檢測範圍內的空氣振動，|簡單說就是{c1}感應聲音{c0}。
DIAG_ADAM_CAVE_2_PAGE_2_B	當E.M.M.I.感應到聲音時，就會{c1}切換成警戒模式移動到感應地點{c0}，|因此你要是{c1}進入E.M.M.I.的視線範圍內{c0}，將會大幅提升危險性。
DIAG_ADAM_CAVE_2_PAGE_3	一旦E.M.M.I.感應到你，就會進入追擊模式，{c1}把你當成目標追擊{c0}，|同時還會關閉E.M.M.I.的行動區域——{c1}「E.M.M.I.區域」的門{c0}。
DIAG_ADAM_CAVE_2_PAGE_3_B	要是陷入這種險境，務必盡全力逃脫。|只要甩掉E.M.M.I.，它就會解除追擊模式，出入口也會再次開放。
DIAG_ADAM_CAVE_2_PAGE_3_C	由於控制E.M.M.I.的系統只能在領域內運作，|因此E.M.M.I.絕不會離開E.M.M.I.領域。
DIAG_ADAM_CAVE_2_PAGE_4	要是不小心被E.M.M.I.捕獲，你有{c1}99%以上的機率會當場死亡{c0}。
DIAG_ADAM_CAVE_2_PAGE_5	逃脫的機率雖不是0%，但幾乎是{c1}不可能成功的{c0}。
DIAG_ADAM_CAVE_2_PAGE_5_B	以目前的情況來說，E.M.M.I.是無人能敵的，|剛才雖然破壞了一台E.M.M.I.，但要是沒有{c1}那種特殊的能量{c0}，|你就只能努力躲避E.M.M.I.，朝出口前進。
DIAG_ADAM_CAVE_2_PAGE_6	進入E.M.M.I.區域時，務必以生存為首要目標。
DIAG_ADAM_CAVE_3_PAGE_1	銀河聯邦的檔案裡，沒有那個襲擊者的詳細資料。|不過，記錄裡提到了鳥人族分化出的{c1}武鬥型民族{c0}，|兩者或許有什麼關聯。
DIAG_ADAM_CAVE_3_PAGE_2	這顆行星的建築跟那支鳥人族的建築十分相似，研判應是他們的母星。|現在雖不清楚對方的企圖，但X的影片很可能是為了引你上鉤的圈套，|目的是要引導你來這裡，並讓E.M.M.I.追捕你。
DIAG_ADAM_CAVE_3_PAGE_3	情況雖然尚未明朗，但你現在的首要目標就是要活著回到星艦上。
DIAG_ADAM_CAVE_3_PAGE_4	剛才啟動岩漿供給裝置後，|關閉的門已經恢復動力了，|{c1}看來往前邁進才是正確的選擇{c0}。
DIAG_ADAM_CAVE_3_PAGE_5	接下來，就試著{c1}取得那種特殊能量{c0}吧，|這是你唯一對抗E.M.M.I.的方法，|不過……
DIAG_ADAM_CAVE_3_PAGE_6	我想你也知道那種能量只是暫時的，|一旦擊敗E.M.M.I.後，那種能量便會消失。
DIAG_ADAM_CAVE_3_PAGE_7	你要牢記有{c1}6台E.M.M.I.{c0}盯上了你，|然而自己卻沒有致勝的武器。
DIAG_ADAM_MAGMA_1_PAGE_1	看來這顆行星是把星球內部的岩漿|在各地循環、供給所產生的能量當成動力。
DIAG_ADAM_MAGMA_1_PAGE_2	目前已經確認管理岩漿供給的中央系統|就在這個{c1}卡塔利斯{c0}。
DIAG_ADAM_MAGMA_1_PAGE_3	這個區域裡有高溫地帶跟岩漿，你現在的服裝{c1}無法抵禦這些環境對你造成的傷害{c0}，|探索時千萬不要踏進那些地方。
DIAG_ADAM_MAGMA_1_PAGE_4	此外，最上方似乎有{c1}穿梭器可通到別的區域{c0}，|就先朝那裡前進吧。
DIAG_ADAM_MAGMA_1_PAGE_5	至於你剛才拿到的{c1}幻影斗篷{c0}。
DIAG_ADAM_MAGMA_1_PAGE_5_B	它的能力發動時，你將能{c1}躲過E.M.M.I.的偵測跟感應{c0}，|雖然先前只能四處逃跑，但你接下來應該能一邊躲避它們，|一邊朝自己的目標前進。
DIAG_ADAM_MAGMA_1_PAGE_6	不過，幻影斗篷發動時，你的{c1}運動能力會明顯下降{c0}。|另外{c1}要是觸碰到E.M.M.I.，一樣會被捕獲{c0}。|因此躲起來時，要注意{c1}訣竅跟姿勢{c0}。
DIAG_ADAM_MAGMA_1_PAGE_6_B	一旦它感應到你，{c1}把你當成目標，那幻影斗篷便派不上任何用場{c0}，|請記住在解除追擊模式前，你就只能逃跑。
DIAG_ADAM_MAGMA_1_PAGE_7	發動幻影斗篷時，一旦消耗完艾翁，就會開始{c1}削減自己的生命能量{c0}，|雖然是把雙面刃，但這並{c1}不會耗盡你的體力{c0}，|要是能熟悉該如何善用它的功能，將會大幅提升你活下來的機率。
DIAG_ADAM_MAGMA_2_PAGE_1	E.M.M.I.可透過更改程式來變更、強化其功能。
DIAG_ADAM_MAGMA_2_PAGE_2	E.M.M.I.的全名為行星外多形態機動調查機……|它的標準規格就是能變形通過狹窄通道，|想必今後遇到的E.M.M.I.會發揮最佳性能，把你逼入絕境吧。
DIAG_ADAM_MAGMA_2_PAGE_3	不過，你現在沒有辦法破壞用特殊材質做成的E.M.M.I.，|就算你{c1}取回自己原本的所有能力，也無法改變這個事實{c0}。
DIAG_ADAM_MAGMA_2_PAGE_4	面對這種無堅不摧的力量，你要認清自己不過是個弱者。
DIAG_ADAM_MAGMA_2_PAGE_6	正確判斷每個E.M.M.I的特性，再用幻影斗篷前進吧。雖然這個危險的能力|不僅會降低你的運動能力，還會在{c1}移動跟射擊時消耗大量艾翁能量{c0}，|但為了要活命可別猶豫，善用這個能力往前吧。
DIAG_ADAM_MAGMA_2_PAGE_8	現在的行動已經偏離原本的任務，不過這也沒有辦法。|目前的情況不容許有任何危險的因素，|要是你取得那種特殊能量，就直接破壞E.M.M.I.吧。
DIAG_ADAM_LAB_1_PAGE_1	看來這個{c1}戴隆{c0}是個生物研究所。|雖然已經修復了一個地方，但區域上方還是有部分地區停電，|只要讓發電機恢復運轉，應該就能恢復供電了。
DIAG_ADAM_LAB_1_PAGE_2	雖然你慢慢取回能力了，但我還無法解析你身上的神秘現象，|因此你仍不可掉以輕心。|前進時務必記得活下來是首要目標。
DIAG_ADAM_AQUA_1_PAGE_1	{c1}巴爾艾尼亞{c0}的下層幾乎泡在水裡，|不用我說你應該也知道|沒有穿重力服的你是不可能在這個區域自由行動的。
DIAG_ADAM_AQUA_1_PAGE_2	抓鉤光束和連跳都|{c1}有助於在水中行動{c0}，你要努力早點取得這些能力。
CAPTION_PROFESSOREVENT_PAGE_01	我是魁特羅布，是蘇哈族的科學家。
CAPTION_PROFESSOREVENT_PAGE_02	襲擊你的鳥人族男人，他的名字叫做雷文畢克。
CAPTION_PROFESSOREVENT_PAGE_03	他擁有優秀的頭腦和體能，是武鬥民族麥歐金族的族長。
CAPTION_PROFESSOREVENT_PAGE_04	我們和同樣是鳥人族的麥歐金族一起封印了在SR388暴走的密特羅德。
CAPTION_PROFESSOREVENT_PAGE_05	變得更加危險的密特羅德本該和行星一起被摧毀。
CAPTION_PROFESSOREVENT_PAGE_05_B	但是……
CAPTION_PROFESSOREVENT_PAGE_06	雷文畢克他……硬是阻止了我們。
CAPTION_PROFESSOREVENT_PAGE_07	密特羅德在盲信著「力量」的他眼裡……
CAPTION_PROFESSOREVENT_PAGE_08	應該就象徵著自己統治銀河的力量吧。
CAPTION_PROFESSOREVENT_PAGE_09	雷文畢克密謀把密特羅德帶到ZDR，並當成生物兵器使用。
CAPTION_PROFESSOREVENT_PAGE_10	因為這個計畫需要可以控制密特羅德的蘇哈族……
CAPTION_PROFESSOREVENT_PAGE_11	所以他只讓我活了下來。
CAPTION_PROFESSOREVENT_PAGE_11_B	雷文畢克和麥歐金族原本打算帶著我暫時回到母星ZDR，|準備回收密特羅德的前置作業。
CAPTION_PROFESSOREVENT_PAGE_12	卻發生了意外事件，計畫只好被迫中斷。
CAPTION_PROFESSOREVENT_PAGE_13	其中一個從SR388歸來的士兵是X擬態出來的。
CAPTION_PROFESSOREVENT_PAGE_14	士兵全都被X寄生了，ZDR陷入前所未有的危機……
CAPTION_PROFESSOREVENT_PAGE_15	雷文畢克費盡千辛萬苦，仍是成功將他們封印了。
CAPTION_PROFESSOREVENT_PAGE_16	隨後他打算重啟計畫……
CAPTION_PROFESSOREVENT_PAGE_17	但SR388上的密特羅德都被你驅逐了。
CAPTION_PROFESSOREVENT_PAGE_18	經過一連串事件，密特羅德滅絕了……
CAPTION_PROFESSOREVENT_PAGE_19	雷文畢克的野心本應就此消失……
CAPTION_PROFESSOREVENT_PAGE_20	如果你沒有出現的話。
CAPTION_PROFESSOREVENT_PAGE_21	E.M.M.I.們被雷文畢克利用了，|薩姆斯・亞蘭……
CAPTION_PROFESSOREVENT_PAGE_22	為了採集存在你體內的「密特羅德DNA」。
CAPTION_PROFESSOREVENT_PAGE_23	別擔心……
CAPTION_PROFESSOREVENT_PAGE_24	我會結束這一切。
CAPTION_PROFESSOREVENT_PAGE_25	我已打開了你應前往之地的門扉。
CAPTION_PROFESSOREVENT_PAGE_26	再來就拜託你了，薩姆斯。
DIAG_ADAM_LAB_2_PAGE_1	從那個蘇哈族男人說的話，可以確定E.M.M.I.追捕你的理由了。|{c1}雷文畢克{c0}為了得到僅存在薩姆斯・亞蘭你體內的密特羅德DNA，|因此將你引來這裡。
DIAG_ADAM_LAB_2_PAGE_2	經我確認，由於{c1}魁特羅布{c0}的操控，|{c1}行星上的E.M.M.I.現已全數陷入靜止狀態{c0}。|現在你應該能不受E.M.M.I.的威脅直攻地表。
DIAG_ADAM_LAB_2_PAGE_3	趕快出發至魁特羅布在{c1}巴爾艾尼亞開啟的地點{c0}吧。
DIAG_ADAM_FOREST_1_PAGE_1	薩姆斯，你已經很接近地表了。|這個區域{c1}賈柏藍{c0}似乎是座地下森林。
DIAG_ADAM_FOREST_1_PAGE_2	雖說E.M.M.I.現在處於靜止狀態，|但雷文畢克仍然覬覦著你身上的密特羅德DNA。|從你抵達行星時和雷文畢克的戰鬥影像來看……
DIAG_ADAM_FOREST_1_PAGE_3	你和他的實力懸殊。雖然你的戰鬥能力正逐漸地回復，|但數據顯示，即便你回復到萬全狀態也是毫無勝算。
DIAG_ADAM_FOREST_1_PAGE_4	有一點我不懂，|那就是雷文畢克當時為什麼沒有殺了你或是把你帶走，|我想這裡面應該有能對抗雷文畢克的關鍵。
CAPTION_QUARANTINE_PAGE_01	掃描完成。
CAPTION_PROFESSORX_PAGE_01	剩下的就拜託你了。
DIAG_ADAM_FOREST_2_PAGE_2	X從被封印的區域解放到行星上了，|這肯定是雷文畢克幹的好事。
DIAG_ADAM_FOREST_2_PAGE_3	但我完全無法理解他的目的為何。|因為你有著密特羅德DNA抗體，還能吸收X，|或許這是雷文畢克在對你釋出某種暗示。
DIAG_ADAM_FOREST_2_PAGE_4	無論如何，|我們最終都得消滅這顆有著X並且持續擴散的行星。|薩姆斯，你趕快回到宇宙艦艇上來吧。
DIAG_ADAM_FOREST_2_PAGE_5	我相信你會平安到達這裡。
DIAG_ADAM_SANC_1_PAGE_1	{c1}菲雷尼亞{c0}看起來曾經是鳥人族舉行儀式的聖地，|但現在已經完全成了廢墟。
DIAG_ADAM_SANC_1_PAGE_2	應該正如魁特羅布所言，|是因為以前X在這顆行星上擴散造成混亂而招致毀滅吧。
DIAG_ADAM_SANC_1_PAGE_3	這個區域已經是X的巢穴了，|我還感應到了其他更強大的X個體。
DIAG_ADAM_SANC_1_PAGE_4	如你所知，曾在此區域襲擊你的E.M.M.I. 不僅能{c1}透視物質{c0}，|還會{c1}發射使目標麻痺的電氣陷阱{c0}。|而現在……
DIAG_ADAM_SANC_1_PAGE_4_B	我確認到E.M.M.I.已重新啟動了。|我們必須假設雷文畢克也能辦到這些事。|只要你能正確地使用幻影斗篷，應該不用太過擔心。
DIAG_ADAM_SANC_1_PAGE_5	小心點，薩姆斯。
DIAG_ADAM_AQUA_2_PAGE_1	X擴散到了整個星球，已經可以說所有的生物都是X了。
DIAG_ADAM_AQUA_2_PAGE_2	此外，或許你也注意到{c1}ZDR的氣溫開始下降{c0}了。
DIAG_ADAM_AQUA_2_PAGE_3	我不知道這和X持續擴散有無關聯，但這顆行星的確開始寒化。|雖然穿著重力服的你{c1}不會因為低溫受到傷害{c0}，|不過為了避免意外，你還是得小心前進。
DIAG_ADAM_CAVE_4_PAGE_1	我已查明為何會有寒化的異常現象了。|因為{c1}卡塔利斯{c0}的能量沒有匯入行星各區域。
DIAG_ADAM_CAVE_4_PAGE_2	尤其可說是行星底部的{c1}阿爾塔利亞{c0}更是嚴峻，那裡{c1}到處都結凍了{c0}。|必須解決這個緊急狀況，讓結凍的門和水恢復原狀。
DIAG_ADAM_CAVE_4_PAGE_3	{c1}卡塔利斯{c0}岩漿能量的中央管理系統本身仍在運作，|恐怕是某種巨大的力量物理性地使機器停止傳輸了。|我推測你很有可能需要跟強大的X對戰。徹底地收拾他吧。
DIAG_ADAM_CAVE_4_PAGE_4	你解決了這個問題後先回來這裡一趟。|這個區域應該留有因寒化現象|而尚未取得的{c1}重要能力{c0}。
DIAG_ADAM_AQUA_3_PAGE_1	薩姆斯，做得好。|你不僅阻止了寒化，還獲得了團身旋擊呢。|現在你能破壞地形前往至今無法通過的地方了。
DIAG_ADAM_AQUA_3_PAGE_2	你的戰鬥能力已經遠強於這次任務開始時，|但我認為仍不足以與雷文畢克抗衡。|如果現在和他對上，你獲勝的可能性極低。
DIAG_ADAM_SHIP_1_PAGE_1	這裡是星球的表面{c1}哈奴比亞{c0}，|你終於上來到這裡了呢。
DIAG_ADAM_SHIP_1_PAGE_2	但是有個問題，|要將雷文畢克連同X葬送這整個星球似乎不太可能，|如果察覺到危險，那傢伙肯定會試著逃脫。
DIAG_ADAM_SHIP_1_PAGE_3	雷文畢克本身就威脅到整個銀河的和平，|而且那傢伙不可能放棄密特羅德DNA。|就算勝算不大，但我們或許該在這裡跟他做個了斷。
DIAG_ADAM_SHIP_1_PAGE_4	我去調查他的位置，|你{c1}過一會兒再來{c0}。
DIAG_ADAM_SHIP_2_PAGE_1	薩姆斯，你新發現的能力……|那種能飛速從目標身上吸取能量的特性|無疑是密特羅德的特徵。
DIAG_ADAM_SHIP_2_PAGE_2	應該是你體內的密特羅德DNA|在長期戰鬥中得到活化，|已經完全覺醒了吧。
DIAG_ADAM_SHIP_2_PAGE_3	有了這股懾人的力量，你肯定能和雷文畢克一較高下。
DIAG_ADAM_SHIP_2_PAGE_4	我在距離{c1}哈奴比亞{c0}非常遙遠的上空發現了{c1}浮遊要塞{c0}，|雷文畢克一定就在那裡。
DIAG_ADAM_SHIP_2_PAGE_5	薩姆斯，時候到了。|你該去完成自己的使命了。
DIAG_ADAM_FINAL_PAGE_01	你擁有的密特羅德DNA，似乎讓你{c1}變成了密特羅德{c0}。|其實這應該在你移植完DNA後馬上就會發生才對……
DIAG_ADAM_FINAL_PAGE_02	大概是你的{c1}蘇哈族基因抑制了變化{c0}吧，|他們是唯一可以抗衡密特羅德的民族。
DIAG_ADAM_FINAL_PAGE_03	雖說你有他們的DNA，但你本身並不是蘇哈族，|從你的體能來看，你大概也被授予了{c1}麥歐金族的DNA{c0}。
DIAG_ADAM_FINAL_PAGE_04	密特羅德的設計似乎是會把麥歐金族視為敵人，|所以……
DIAG_ADAM_FINAL_PAGE_05	最初很有可能是一開始在遭遇雷文畢克襲擊時，|那次經驗讓你體內密特羅德的戰鬥本能覺醒了。
DIAG_ADAM_FINAL_PAGE_06	之後你便快速的密特羅德化，|直到{c1}終於無法抗衡了{c0}，而變成現在這個狀態。
DIAG_ADAM_FINAL_PAGE_07	如今已變成密特羅德的薩姆斯・亞蘭，|對整個銀河社會而言，是極為危險的威脅。
DIAG_ADAM_FINAL_PAGE_08	但你不必覺得難過，|有個辦法能讓變化後的你正確地使用這股力量，對銀河社會有所貢獻。
DIAG_ADAM_FINAL_PAGE_09	就像你聽從我的指示到達這裡……|只要你今後也乖乖地聽命於我一人就可以了。
DIAG_ADAM_FINAL_PAGE_10	我很滿意你在ZDR精采的表現，|而且你居然還讓密特羅德的能力覺醒了……
DIAG_ADAM_FINAL_PAGE_11	看來那時候我看出了你的潛能，|讓你活著是對的……
DIAG_ADAM_FINAL_PAGE_12	現在就臣服於我，讓你那難得的能力為我所用吧！|唯有我的計畫，才能維持銀河社會的秩序。
DIAG_ADAM_FINAL_PAGE_13	薩姆斯，好好完成自己的使命吧。這是命令，不許你有異議。
DIAG_ADAM_FINAL_PAGE_14	你太讓我失望了……
DIAG_ADAM_FINAL_PAGE_15	我的女兒啊。
CAPTION_HYPERMETROIDNIZATIONEVENT_PAGE_01	你真以為你能夠打敗我嗎？不自量力……
CAPTION_HYPERMETROIDNIZATIONEVENT_PAGE_02	你已經失去利用價值了，現在我再也不需要密特羅德DNA了。|因為……
CAPTION_HYPERMETROIDNIZATIONEVENT_PAGE_03	我可以製造最強的密特羅德……薩姆斯・亞蘭的複製人。
CAPTION_HYPERMETROIDNIZATIONEVENT_PAGE_04	沒有任何人可以反抗我。
CAPTION_HYPERMETROIDNIZATIONEVENT_PAGE_05	我愚蠢的女兒啊，你就把銀河的未來交給我，安心的沉睡吧……
CAPTION_HYPERMETROIDNIZATIONEVENT_PAGE_06	力量就是一切……
CAPTION_COMMANDERX_PAGE_01	薩姆斯……！
CAPTION_COMMANDERX_PAGE_02	力量就是一切……
CAPTION_COMMANDERX_PAGE_03	為了擁有力量，必須有所犧牲……
CAPTION_ENDGAME_PAGE_1	住手！
CAPTION_ENDGAME_PAGE_2	艦艇的能量將被吸收殆盡。
